rep,nrNodes,nrEdges,edgeProb,nrPaths,nrFails,failureModel,failurePercent,hopsRanked,hopsUnranked,spLength,stretch_mult,nodeAdditions,hopsPath,stretch_path,hopsRankedOne,hopsUnrankedOne,stretch_one,overallNodeAdditionsOne,treeChoice
1000,197,243,graphml/Cogentco.graphml,3,,clustered,0.4;-0.3,9,9,7,2,0,9,2,9,9,2,0,edgeCount
999,197,243,graphml/Cogentco.graphml,1,,clustered,0.4;-0.3,15,15,15,0,0,15,0,15,15,0,0,edgeCount
998,197,243,graphml/Cogentco.graphml,2,,clustered,0.4;-0.3,16,16,15,1,2,16,1,16,16,1,2,edgeCount
997,197,243,graphml/Cogentco.graphml,2,,clustered,0.4;-0.3,7,7,5,2,0,7,2,7,7,2,0,edgeCount
996,197,243,graphml/Cogentco.graphml,1,,clustered,0.4;-0.3,15,15,15,0,0,15,0,15,15,0,0,edgeCount
995,197,243,graphml/Cogentco.graphml,2,,clustered,0.4;-0.3,6,14,3,3,4,3,0,3,3,0,4,edgeCount
994,197,243,graphml/Cogentco.graphml,2,,clustered,0.4;-0.3,42,17,10,32,2,10,0,10,10,0,2,edgeCount
993,197,243,graphml/Cogentco.graphml,2,,clustered,0.4;-0.3,18,14,10,8,2,34,24,34,34,24,2,edgeCount
992,197,243,graphml/Cogentco.graphml,2,,clustered,0.4;-0.3,12,12,12,0,0,12,0,12,12,0,0,edgeCount
991,197,243,graphml/Cogentco.graphml,2,,clustered,0.4;-0.3,13,16,8,5,4,8,0,8,8,0,2,edgeCount
990,197,243,graphml/Cogentco.graphml,1,,clustered,0.4;-0.3,11,11,10,1,4,-1,-11,11,11,1,4,edgeCount
989,197,243,graphml/Cogentco.graphml,2,,clustered,0.4;-0.3,10,8,8,2,0,9,1,9,9,1,0,edgeCount
988,197,243,graphml/Cogentco.graphml,2,,clustered,0.4;-0.3,44,10,10,34,2,10,0,10,10,0,2,edgeCount
987,197,243,graphml/Cogentco.graphml,2,,clustered,0.4;-0.3,25,46,16,9,4,55,39,55,67,39,4,edgeCount
986,197,243,graphml/Cogentco.graphml,2,,clustered,0.4;-0.3,12,8,8,4,2,24,16,24,24,16,2,edgeCount
985,197,243,graphml/Cogentco.graphml,2,,clustered,0.4;-0.3,7,7,7,0,0,7,0,7,7,0,0,edgeCount
984,197,243,graphml/Cogentco.graphml,1,,clustered,0.4;-0.3,14,14,14,0,2,14,0,14,14,0,2,edgeCount
983,197,243,graphml/Cogentco.graphml,1,,clustered,0.4;-0.3,22,25,22,0,2,22,0,22,25,0,2,edgeCount
982,197,243,graphml/Cogentco.graphml,2,,clustered,0.4;-0.3,19,19,16,3,0,19,3,19,19,3,0,edgeCount
981,197,243,graphml/Cogentco.graphml,1,,clustered,0.4;-0.3,10,10,10,0,0,10,0,10,10,0,0,edgeCount
980,197,243,graphml/Cogentco.graphml,2,,clustered,0.4;-0.3,5,14,5,0,0,5,0,5,5,0,0,edgeCount
979,197,243,graphml/Cogentco.graphml,1,,clustered,0.4;-0.3,4,4,4,0,0,4,0,4,4,0,0,edgeCount
978,197,243,graphml/Cogentco.graphml,2,,clustered,0.4;-0.3,5,5,5,0,0,5,0,5,5,0,0,edgeCount
977,197,243,graphml/Cogentco.graphml,1,,clustered,0.4;-0.3,7,7,7,0,0,7,0,7,7,0,0,edgeCount
976,197,243,graphml/Cogentco.graphml,2,,clustered,0.4;-0.3,29,7,7,22,2,7,0,7,7,0,2,edgeCount
975,197,243,graphml/Cogentco.graphml,2,,clustered,0.4;-0.3,14,14,11,3,0,19,8,14,14,3,0,edgeCount
974,197,243,graphml/Cogentco.graphml,2,,clustered,0.4;-0.3,12,12,10,2,0,12,2,12,12,2,0,edgeCount
973,197,243,graphml/Cogentco.graphml,2,,clustered,0.4;-0.3,13,10,10,3,0,10,0,10,10,0,0,edgeCount
972,197,243,graphml/Cogentco.graphml,2,,clustered,0.4;-0.3,10,9,9,1,0,9,0,9,9,0,0,edgeCount
971,197,243,graphml/Cogentco.graphml,2,,clustered,0.4;-0.3,4,4,4,0,2,5,1,5,4,1,2,edgeCount
970,197,243,graphml/Cogentco.graphml,2,,clustered,0.4;-0.3,10,10,9,1,2,10,1,10,10,1,2,edgeCount
969,197,243,graphml/Cogentco.graphml,1,,clustered,0.4;-0.3,21,21,21,0,0,21,0,21,21,0,0,edgeCount
968,197,243,graphml/Cogentco.graphml,2,,clustered,0.4;-0.3,12,11,8,4,0,12,4,12,11,4,0,edgeCount
967,197,243,graphml/Cogentco.graphml,2,,clustered,0.4;-0.3,4,4,4,0,0,4,0,4,4,0,0,edgeCount
966,197,243,graphml/Cogentco.graphml,2,,clustered,0.4;-0.3,3,3,3,0,0,3,0,3,3,0,0,edgeCount
965,197,243,graphml/Cogentco.graphml,2,,clustered,0.4;-0.3,13,12,12,1,0,12,0,12,12,0,0,edgeCount
964,197,243,graphml/Cogentco.graphml,2,,clustered,0.4;-0.3,25,25,22,3,0,25,3,25,25,3,0,edgeCount
963,197,243,graphml/Cogentco.graphml,2,,clustered,0.4;-0.3,9,9,9,0,0,13,4,9,9,0,0,edgeCount
962,197,243,graphml/Cogentco.graphml,1,,clustered,0.4;-0.3,2,2,2,0,4,2,0,2,2,0,4,edgeCount
961,197,243,graphml/Cogentco.graphml,2,,clustered,0.4;-0.3,13,13,13,0,0,13,0,13,13,0,0,edgeCount
960,197,243,graphml/Cogentco.graphml,3,,clustered,0.4;-0.3,18,21,15,3,0,50,35,50,50,35,0,edgeCount
959,197,243,graphml/Cogentco.graphml,2,,clustered,0.4;-0.3,40,12,12,28,2,12,0,12,12,0,2,edgeCount
958,197,243,graphml/Cogentco.graphml,2,,clustered,0.4;-0.3,12,10,10,2,0,10,0,10,10,0,0,edgeCount
957,197,243,graphml/Cogentco.graphml,2,,clustered,0.4;-0.3,16,23,15,1,0,16,1,16,16,1,0,edgeCount
956,197,243,graphml/Cogentco.graphml,2,,clustered,0.4;-0.3,22,22,18,4,0,22,4,22,22,4,0,edgeCount
955,197,243,graphml/Cogentco.graphml,2,,clustered,0.4;-0.3,8,12,8,0,2,8,0,8,12,0,2,edgeCount
954,197,243,graphml/Cogentco.graphml,2,,clustered,0.4;-0.3,24,24,21,3,0,24,3,24,24,3,0,edgeCount
953,197,243,graphml/Cogentco.graphml,2,,clustered,0.4;-0.3,6,30,6,0,2,14,8,6,30,0,2,edgeCount
952,197,243,graphml/Cogentco.graphml,1,,clustered,0.4;-0.3,2,2,2,0,0,2,0,2,2,0,0,edgeCount
951,197,243,graphml/Cogentco.graphml,3,,clustered,0.4;-0.3,12,9,8,4,0,32,24,32,32,24,0,edgeCount
950,197,243,graphml/Cogentco.graphml,1,,clustered,0.4;-0.3,8,8,8,0,0,8,0,8,8,0,0,edgeCount
949,197,243,graphml/Cogentco.graphml,2,,clustered,0.4;-0.3,24,8,8,16,2,8,0,8,8,0,2,edgeCount
948,197,243,graphml/Cogentco.graphml,2,,clustered,0.4;-0.3,16,16,13,3,0,16,3,16,16,3,0,edgeCount
947,197,243,graphml/Cogentco.graphml,2,,clustered,0.4;-0.3,3,3,3,0,2,3,0,3,3,0,2,edgeCount
946,197,243,graphml/Cogentco.graphml,2,,clustered,0.4;-0.3,19,19,19,0,0,19,0,19,19,0,0,edgeCount
945,197,243,graphml/Cogentco.graphml,1,,clustered,0.4;-0.3,44,44,20,24,4,-1,-21,44,44,24,4,edgeCount
944,197,243,graphml/Cogentco.graphml,2,,clustered,0.4;-0.3,26,26,19,7,0,26,7,26,26,7,0,edgeCount
943,197,243,graphml/Cogentco.graphml,2,,clustered,0.4;-0.3,12,12,12,0,0,12,0,12,12,0,0,edgeCount
942,197,243,graphml/Cogentco.graphml,2,,clustered,0.4;-0.3,8,8,8,0,2,8,0,8,8,0,2,edgeCount
941,197,243,graphml/Cogentco.graphml,2,,clustered,0.4;-0.3,15,15,13,2,2,36,23,36,36,23,2,edgeCount
940,197,243,graphml/Cogentco.graphml,2,,clustered,0.4;-0.3,7,7,4,3,0,7,3,7,7,3,0,edgeCount
939,197,243,graphml/Cogentco.graphml,2,,clustered,0.4;-0.3,23,23,23,0,0,23,0,23,23,0,0,edgeCount
938,197,243,graphml/Cogentco.graphml,1,,clustered,0.4;-0.3,16,16,16,0,2,16,0,16,16,0,2,edgeCount
937,197,243,graphml/Cogentco.graphml,2,,clustered,0.4;-0.3,11,11,8,3,0,11,3,11,11,3,0,edgeCount
936,197,243,graphml/Cogentco.graphml,1,,clustered,0.4;-0.3,17,17,17,0,2,17,0,17,17,0,2,edgeCount
935,197,243,graphml/Cogentco.graphml,1,,clustered,0.4;-0.3,8,8,8,0,0,8,0,8,8,0,0,edgeCount
934,197,243,graphml/Cogentco.graphml,1,,clustered,0.4;-0.3,9,25,9,0,4,9,0,9,25,0,4,edgeCount
933,197,243,graphml/Cogentco.graphml,2,,clustered,0.4;-0.3,8,6,5,3,0,8,3,8,6,3,0,edgeCount
932,197,243,graphml/Cogentco.graphml,1,,clustered,0.4;-0.3,13,13,13,0,2,13,0,13,13,0,2,edgeCount
931,197,243,graphml/Cogentco.graphml,2,,clustered,0.4;-0.3,43,13,13,30,6,16,3,43,13,30,6,edgeCount
930,197,243,graphml/Cogentco.graphml,2,,clustered,0.4;-0.3,12,12,12,0,0,12,0,12,12,0,0,edgeCount
929,197,243,graphml/Cogentco.graphml,2,,clustered,0.4;-0.3,12,12,9,3,0,12,3,12,12,3,0,edgeCount
928,197,243,graphml/Cogentco.graphml,2,,clustered,0.4;-0.3,8,8,8,0,0,8,0,8,8,0,0,edgeCount
927,197,243,graphml/Cogentco.graphml,1,,clustered,0.4;-0.3,8,8,8,0,0,8,0,8,8,0,0,edgeCount
926,197,243,graphml/Cogentco.graphml,3,,clustered,0.4;-0.3,36,36,10,26,0,36,26,36,36,26,0,edgeCount
925,197,243,graphml/Cogentco.graphml,1,,clustered,0.4;-0.3,9,9,9,0,0,9,0,9,9,0,0,edgeCount
924,197,243,graphml/Cogentco.graphml,3,,clustered,0.4;-0.3,11,40,8,3,0,8,0,8,8,0,0,edgeCount
923,197,243,graphml/Cogentco.graphml,2,,clustered,0.4;-0.3,13,13,13,0,0,13,0,13,13,0,0,edgeCount
922,197,243,graphml/Cogentco.graphml,2,,clustered,0.4;-0.3,21,22,18,3,0,18,0,18,18,0,0,edgeCount
921,197,243,graphml/Cogentco.graphml,2,,clustered,0.4;-0.3,20,20,19,1,0,20,1,20,20,1,0,edgeCount
920,197,243,graphml/Cogentco.graphml,1,,clustered,0.4;-0.3,6,22,6,0,4,6,0,6,22,0,4,edgeCount
919,197,243,graphml/Cogentco.graphml,2,,clustered,0.4;-0.3,9,7,7,2,4,23,16,7,7,0,4,edgeCount
918,197,243,graphml/Cogentco.graphml,2,,clustered,0.4;-0.3,14,14,9,5,0,14,5,14,14,5,0,edgeCount
917,197,243,graphml/Cogentco.graphml,2,,clustered,0.4;-0.3,22,22,22,0,0,22,0,22,22,0,0,edgeCount
916,197,243,graphml/Cogentco.graphml,2,,clustered,0.4;-0.3,15,15,10,5,0,15,5,15,15,5,0,edgeCount
915,197,243,graphml/Cogentco.graphml,2,,clustered,0.4;-0.3,16,21,12,4,4,36,24,36,41,24,4,edgeCount
914,197,243,graphml/Cogentco.graphml,1,,clustered,0.4;-0.3,32,38,13,19,12,-1,-14,32,38,19,12,edgeCount
913,197,243,graphml/Cogentco.graphml,2,,clustered,0.4;-0.3,10,10,6,4,0,10,4,10,10,4,0,edgeCount
912,197,243,graphml/Cogentco.graphml,2,,clustered,0.4;-0.3,6,4,4,2,2,4,0,6,4,2,2,edgeCount
911,197,243,graphml/Cogentco.graphml,2,,clustered,0.4;-0.3,9,10,9,0,0,10,1,10,10,1,0,edgeCount
910,197,243,graphml/Cogentco.graphml,1,,clustered,0.4;-0.3,4,4,4,0,0,4,0,4,4,0,0,edgeCount
909,197,243,graphml/Cogentco.graphml,1,,clustered,0.4;-0.3,11,11,11,0,0,11,0,11,11,0,0,edgeCount
908,197,243,graphml/Cogentco.graphml,2,,clustered,0.4;-0.3,17,17,13,4,0,17,4,17,17,4,0,edgeCount
907,197,243,graphml/Cogentco.graphml,1,,clustered,0.4;-0.3,9,9,9,0,2,9,0,9,9,0,2,edgeCount
906,197,243,graphml/Cogentco.graphml,2,,clustered,0.4;-0.3,25,14,11,14,0,14,3,14,14,3,0,edgeCount
905,197,243,graphml/Cogentco.graphml,1,,clustered,0.4;-0.3,14,14,14,0,0,14,0,14,14,0,0,edgeCount
904,197,243,graphml/Cogentco.graphml,1,,clustered,0.4;-0.3,13,13,13,0,0,13,0,13,13,0,0,edgeCount
903,197,243,graphml/Cogentco.graphml,1,,clustered,0.4;-0.3,17,17,17,0,12,17,0,17,17,0,12,edgeCount
902,197,243,graphml/Cogentco.graphml,2,,clustered,0.4;-0.3,8,8,8,0,0,8,0,8,8,0,0,edgeCount
901,197,243,graphml/Cogentco.graphml,1,,clustered,0.4;-0.3,11,11,11,0,0,11,0,11,11,0,0,edgeCount
900,197,243,graphml/Cogentco.graphml,2,,clustered,0.4;-0.3,11,27,9,2,2,23,14,23,23,14,2,edgeCount
899,197,243,graphml/Cogentco.graphml,2,,clustered,0.4;-0.3,9,9,9,0,0,9,0,9,9,0,0,edgeCount
898,197,243,graphml/Cogentco.graphml,2,,clustered,0.4;-0.3,19,19,15,4,0,19,4,19,19,4,0,edgeCount
897,197,243,graphml/Cogentco.graphml,2,,clustered,0.4;-0.3,2,2,2,0,0,2,0,2,2,0,0,edgeCount
896,197,243,graphml/Cogentco.graphml,1,,clustered,0.4;-0.3,8,8,8,0,2,8,0,8,8,0,2,edgeCount
895,197,243,graphml/Cogentco.graphml,1,,clustered,0.4;-0.3,-1,-1,-1,0,0,-1,0,-1,-1,0,0,edgeCount
894,197,243,graphml/Cogentco.graphml,2,,clustered,0.4;-0.3,35,23,11,24,4,11,0,11,11,0,4,edgeCount
893,197,243,graphml/Cogentco.graphml,2,,clustered,0.4;-0.3,25,25,9,16,0,9,0,25,25,16,0,edgeCount
892,197,243,graphml/Cogentco.graphml,3,,clustered,0.4;-0.3,12,10,10,2,0,10,0,10,10,0,0,edgeCount
891,197,243,graphml/Cogentco.graphml,2,,clustered,0.4;-0.3,8,8,5,3,0,8,3,8,8,3,0,edgeCount
890,197,243,graphml/Cogentco.graphml,2,,clustered,0.4;-0.3,18,22,11,7,0,17,6,17,17,6,0,edgeCount
889,197,243,graphml/Cogentco.graphml,2,,clustered,0.4;-0.3,16,14,10,6,12,30,20,30,35,20,10,edgeCount
888,197,243,graphml/Cogentco.graphml,2,,clustered,0.4;-0.3,23,23,20,3,2,68,48,23,23,3,2,edgeCount
887,197,243,graphml/Cogentco.graphml,1,,clustered,0.4;-0.3,15,20,15,0,4,15,0,15,20,0,4,edgeCount
886,197,243,graphml/Cogentco.graphml,1,,clustered,0.4;-0.3,20,20,20,0,2,20,0,20,20,0,2,edgeCount
885,197,243,graphml/Cogentco.graphml,2,,clustered,0.4;-0.3,8,16,8,0,0,36,28,36,36,28,0,edgeCount
884,197,243,graphml/Cogentco.graphml,2,,clustered,0.4;-0.3,27,14,14,13,2,14,0,14,14,0,2,edgeCount
883,197,243,graphml/Cogentco.graphml,3,,clustered,0.4;-0.3,13,7,3,10,0,3,0,3,3,0,0,edgeCount
882,197,243,graphml/Cogentco.graphml,2,,clustered,0.4;-0.3,15,15,15,0,0,15,0,15,15,0,0,edgeCount
881,197,243,graphml/Cogentco.graphml,2,,clustered,0.4;-0.3,14,14,14,0,0,14,0,14,14,0,0,edgeCount
880,197,243,graphml/Cogentco.graphml,1,,clustered,0.4;-0.3,8,8,8,0,0,8,0,8,8,0,0,edgeCount
879,197,243,graphml/Cogentco.graphml,1,,clustered,0.4;-0.3,19,19,19,0,2,19,0,19,19,0,2,edgeCount
878,197,243,graphml/Cogentco.graphml,2,,clustered,0.4;-0.3,10,10,10,0,2,10,0,10,10,0,2,edgeCount
877,197,243,graphml/Cogentco.graphml,1,,clustered,0.4;-0.3,9,9,9,0,4,9,0,9,9,0,4,edgeCount
876,197,243,graphml/Cogentco.graphml,1,,clustered,0.4;-0.3,-1,-1,-1,0,0,-1,0,-1,-1,0,0,edgeCount
875,197,243,graphml/Cogentco.graphml,1,,clustered,0.4;-0.3,20,20,20,0,0,20,0,20,20,0,0,edgeCount
874,197,243,graphml/Cogentco.graphml,2,,clustered,0.4;-0.3,38,10,10,28,2,-1,-11,-1,-1,-11,2,edgeCount
873,197,243,graphml/Cogentco.graphml,1,,clustered,0.4;-0.3,19,24,19,0,2,19,0,19,24,0,2,edgeCount
872,197,243,graphml/Cogentco.graphml,2,,clustered,0.4;-0.3,9,6,6,3,0,6,0,6,6,0,0,edgeCount
871,197,243,graphml/Cogentco.graphml,3,,clustered,0.4;-0.3,4,4,4,0,0,7,3,7,4,3,0,edgeCount
870,197,243,graphml/Cogentco.graphml,2,,clustered,0.4;-0.3,2,2,2,0,0,2,0,2,2,0,0,edgeCount
869,197,243,graphml/Cogentco.graphml,2,,clustered,0.4;-0.3,10,10,10,0,0,37,27,37,37,27,0,edgeCount
868,197,243,graphml/Cogentco.graphml,1,,clustered,0.4;-0.3,9,14,9,0,2,9,0,9,14,0,2,edgeCount
867,197,243,graphml/Cogentco.graphml,1,,clustered,0.4;-0.3,13,13,13,0,0,13,0,13,13,0,0,edgeCount
866,197,243,graphml/Cogentco.graphml,2,,clustered,0.4;-0.3,9,6,6,3,0,6,0,6,6,0,0,edgeCount
865,197,243,graphml/Cogentco.graphml,2,,clustered,0.4;-0.3,22,22,15,7,2,22,7,22,22,7,2,edgeCount
864,197,243,graphml/Cogentco.graphml,2,,clustered,0.4;-0.3,13,13,13,0,0,13,0,13,13,0,0,edgeCount
863,197,243,graphml/Cogentco.graphml,2,,clustered,0.4;-0.3,13,13,13,0,0,13,0,13,13,0,0,edgeCount
862,197,243,graphml/Cogentco.graphml,2,,clustered,0.4;-0.3,19,19,19,0,0,19,0,19,19,0,0,edgeCount
861,197,243,graphml/Cogentco.graphml,2,,clustered,0.4;-0.3,6,6,6,0,0,6,0,6,6,0,0,edgeCount
860,197,243,graphml/Cogentco.graphml,2,,clustered,0.4;-0.3,8,8,8,0,0,8,0,8,8,0,0,edgeCount
859,197,243,graphml/Cogentco.graphml,2,,clustered,0.4;-0.3,12,12,12,0,0,12,0,12,12,0,0,edgeCount
858,197,243,graphml/Cogentco.graphml,2,,clustered,0.4;-0.3,15,16,12,3,0,14,2,14,14,2,0,edgeCount
857,197,243,graphml/Cogentco.graphml,2,,clustered,0.4;-0.3,10,10,10,0,0,10,0,10,10,0,0,edgeCount
856,197,243,graphml/Cogentco.graphml,2,,clustered,0.4;-0.3,12,16,11,1,2,32,21,12,16,1,2,edgeCount
855,197,243,graphml/Cogentco.graphml,2,,clustered,0.4;-0.3,10,7,7,3,4,7,0,7,7,0,4,edgeCount
854,197,243,graphml/Cogentco.graphml,1,,clustered,0.4;-0.3,6,9,6,0,2,6,0,6,9,0,2,edgeCount
853,197,243,graphml/Cogentco.graphml,3,,clustered,0.4;-0.3,37,34,10,27,2,33,23,33,33,23,2,edgeCount
852,197,243,graphml/Cogentco.graphml,2,,clustered,0.4;-0.3,13,17,9,4,0,9,0,9,9,0,0,edgeCount
851,197,243,graphml/Cogentco.graphml,2,,clustered,0.4;-0.3,6,16,6,0,2,16,10,6,16,0,2,edgeCount
850,197,243,graphml/Cogentco.graphml,1,,clustered,0.4;-0.3,16,27,16,0,4,16,0,16,27,0,4,edgeCount
849,197,243,graphml/Cogentco.graphml,1,,clustered,0.4;-0.3,6,30,6,0,4,6,0,6,30,0,4,edgeCount
848,197,243,graphml/Cogentco.graphml,1,,clustered,0.4;-0.3,4,4,4,0,2,4,0,4,4,0,2,edgeCount
847,197,243,graphml/Cogentco.graphml,2,,clustered,0.4;-0.3,4,4,4,0,0,4,0,4,4,0,0,edgeCount
846,197,243,graphml/Cogentco.graphml,2,,clustered,0.4;-0.3,21,19,7,14,4,7,0,7,7,0,4,edgeCount
845,197,243,graphml/Cogentco.graphml,2,,clustered,0.4;-0.3,15,15,15,0,0,15,0,15,15,0,0,edgeCount
844,197,243,graphml/Cogentco.graphml,1,,clustered,0.4;-0.3,18,18,18,0,0,18,0,18,18,0,0,edgeCount
843,197,243,graphml/Cogentco.graphml,2,,clustered,0.4;-0.3,12,12,12,0,0,12,0,12,12,0,0,edgeCount
842,197,243,graphml/Cogentco.graphml,2,,clustered,0.4;-0.3,9,9,9,0,0,9,0,9,9,0,0,edgeCount
841,197,243,graphml/Cogentco.graphml,2,,clustered,0.4;-0.3,17,17,14,3,0,17,3,17,17,3,0,edgeCount
840,197,243,graphml/Cogentco.graphml,2,,clustered,0.4;-0.3,19,51,15,4,6,-1,-16,48,18,33,6,edgeCount
839,197,243,graphml/Cogentco.graphml,1,,clustered,0.4;-0.3,4,4,4,0,0,4,0,4,4,0,0,edgeCount
838,197,243,graphml/Cogentco.graphml,2,,clustered,0.4;-0.3,14,14,14,0,2,14,0,14,14,0,2,edgeCount
837,197,243,graphml/Cogentco.graphml,2,,clustered,0.4;-0.3,14,14,14,0,0,14,0,14,14,0,0,edgeCount
836,197,243,graphml/Cogentco.graphml,3,,clustered,0.4;-0.3,16,16,15,1,0,16,1,16,16,1,0,edgeCount
835,197,243,graphml/Cogentco.graphml,1,,clustered,0.4;-0.3,40,34,15,25,4,-1,-16,40,34,25,4,edgeCount
834,197,243,graphml/Cogentco.graphml,1,,clustered,0.4;-0.3,11,11,11,0,0,11,0,11,11,0,0,edgeCount
833,197,243,graphml/Cogentco.graphml,2,,clustered,0.4;-0.3,12,12,12,0,0,15,3,12,12,0,0,edgeCount
832,197,243,graphml/Cogentco.graphml,1,,clustered,0.4;-0.3,13,13,13,0,2,13,0,13,13,0,2,edgeCount
831,197,243,graphml/Cogentco.graphml,1,,clustered,0.4;-0.3,16,31,16,0,4,16,0,16,31,0,4,edgeCount
830,197,243,graphml/Cogentco.graphml,2,,clustered,0.4;-0.3,23,45,19,4,2,57,38,57,57,38,2,edgeCount
829,197,243,graphml/Cogentco.graphml,1,,clustered,0.4;-0.3,20,20,20,0,0,20,0,20,20,0,0,edgeCount
828,197,243,graphml/Cogentco.graphml,1,,clustered,0.4;-0.3,16,24,16,0,2,16,0,16,24,0,2,edgeCount
827,197,243,graphml/Cogentco.graphml,2,,clustered,0.4;-0.3,10,10,7,3,0,10,3,10,10,3,0,edgeCount
826,197,243,graphml/Cogentco.graphml,3,,clustered,0.4;-0.3,40,14,10,30,4,14,4,14,14,4,4,edgeCount
825,197,243,graphml/Cogentco.graphml,2,,clustered,0.4;-0.3,15,21,13,2,0,13,0,13,13,0,0,edgeCount
824,197,243,graphml/Cogentco.graphml,2,,clustered,0.4;-0.3,4,4,4,0,2,4,0,4,4,0,2,edgeCount
823,197,243,graphml/Cogentco.graphml,2,,clustered,0.4;-0.3,29,29,8,21,0,29,21,29,29,21,0,edgeCount
822,197,243,graphml/Cogentco.graphml,1,,clustered,0.4;-0.3,8,8,8,0,0,8,0,8,8,0,0,edgeCount
821,197,243,graphml/Cogentco.graphml,2,,clustered,0.4;-0.3,10,4,4,6,2,4,0,4,4,0,2,edgeCount
820,197,243,graphml/Cogentco.graphml,2,,clustered,0.4;-0.3,19,19,19,0,0,19,0,19,19,0,0,edgeCount
819,197,243,graphml/Cogentco.graphml,1,,clustered,0.4;-0.3,9,9,9,0,0,9,0,9,9,0,0,edgeCount
818,197,243,graphml/Cogentco.graphml,2,,clustered,0.4;-0.3,9,9,9,0,0,9,0,9,9,0,0,edgeCount
817,197,243,graphml/Cogentco.graphml,2,,clustered,0.4;-0.3,8,20,8,0,2,12,4,12,12,4,2,edgeCount
816,197,243,graphml/Cogentco.graphml,2,,clustered,0.4;-0.3,16,16,15,1,2,18,3,18,16,3,2,edgeCount
815,197,243,graphml/Cogentco.graphml,1,,clustered,0.4;-0.3,18,18,18,0,2,18,0,18,18,0,2,edgeCount
814,197,243,graphml/Cogentco.graphml,2,,clustered,0.4;-0.3,40,12,12,28,4,12,0,12,12,0,4,edgeCount
813,197,243,graphml/Cogentco.graphml,1,,clustered,0.4;-0.3,10,10,10,0,2,10,0,10,10,0,2,edgeCount
812,197,243,graphml/Cogentco.graphml,3,,clustered,0.4;-0.3,9,17,8,1,0,8,0,8,8,0,0,edgeCount
811,197,243,graphml/Cogentco.graphml,2,,clustered,0.4;-0.3,18,18,12,6,0,18,6,18,18,6,0,edgeCount
810,197,243,graphml/Cogentco.graphml,2,,clustered,0.4;-0.3,11,11,11,0,0,11,0,11,11,0,0,edgeCount
809,197,243,graphml/Cogentco.graphml,2,,clustered,0.4;-0.3,9,9,9,0,0,9,0,9,9,0,0,edgeCount
808,197,243,graphml/Cogentco.graphml,2,,clustered,0.4;-0.3,15,15,10,5,0,15,5,15,15,5,0,edgeCount
807,197,243,graphml/Cogentco.graphml,2,,clustered,0.4;-0.3,42,25,14,28,2,14,0,42,25,28,2,edgeCount
806,197,243,graphml/Cogentco.graphml,2,,clustered,0.4;-0.3,22,22,22,0,0,22,0,22,22,0,0,edgeCount
805,197,243,graphml/Cogentco.graphml,2,,clustered,0.4;-0.3,7,7,7,0,0,7,0,7,7,0,0,edgeCount
804,197,243,graphml/Cogentco.graphml,2,,clustered,0.4;-0.3,22,22,21,1,0,22,1,22,22,1,0,edgeCount
803,197,243,graphml/Cogentco.graphml,2,,clustered,0.4;-0.3,7,16,5,2,0,5,0,5,5,0,0,edgeCount
802,197,243,graphml/Cogentco.graphml,2,,clustered,0.4;-0.3,5,5,5,0,0,5,0,5,5,0,0,edgeCount
801,197,243,graphml/Cogentco.graphml,2,,clustered,0.4;-0.3,4,4,4,0,0,4,0,4,4,0,0,edgeCount
800,197,243,graphml/Cogentco.graphml,2,,clustered,0.4;-0.3,13,13,13,0,0,13,0,13,13,0,0,edgeCount
799,197,243,graphml/Cogentco.graphml,1,,clustered,0.4;-0.3,14,14,14,0,2,14,0,14,14,0,2,edgeCount
798,197,243,graphml/Cogentco.graphml,2,,clustered,0.4;-0.3,20,15,6,14,4,28,22,28,28,22,4,edgeCount
797,197,243,graphml/Cogentco.graphml,2,,clustered,0.4;-0.3,24,54,17,7,2,54,37,54,54,37,2,edgeCount
796,197,243,graphml/Cogentco.graphml,2,,clustered,0.4;-0.3,16,26,16,0,2,16,0,16,26,0,2,edgeCount
795,197,243,graphml/Cogentco.graphml,2,,clustered,0.4;-0.3,18,18,17,1,2,55,38,18,18,1,2,edgeCount
794,197,243,graphml/Cogentco.graphml,2,,clustered,0.4;-0.3,16,20,15,1,2,16,1,16,20,1,2,edgeCount
793,197,243,graphml/Cogentco.graphml,2,,clustered,0.4;-0.3,8,8,8,0,0,8,0,8,8,0,0,edgeCount
792,197,243,graphml/Cogentco.graphml,1,,clustered,0.4;-0.3,4,11,4,0,2,4,0,4,11,0,2,edgeCount
791,197,243,graphml/Cogentco.graphml,2,,clustered,0.4;-0.3,49,27,17,32,2,17,0,17,22,0,2,edgeCount
790,197,243,graphml/Cogentco.graphml,1,,clustered,0.4;-0.3,8,8,8,0,0,8,0,8,8,0,0,edgeCount
789,197,243,graphml/Cogentco.graphml,2,,clustered,0.4;-0.3,29,9,9,20,2,9,0,9,9,0,2,edgeCount
788,197,243,graphml/Cogentco.graphml,2,,clustered,0.4;-0.3,23,16,15,8,0,16,1,16,16,1,0,edgeCount
787,197,243,graphml/Cogentco.graphml,2,,clustered,0.4;-0.3,11,16,11,0,2,27,16,11,16,0,2,edgeCount
786,197,243,graphml/Cogentco.graphml,2,,clustered,0.4;-0.3,10,10,10,0,2,10,0,10,10,0,2,edgeCount
785,197,243,graphml/Cogentco.graphml,1,,clustered,0.4;-0.3,11,11,11,0,2,11,0,11,11,0,2,edgeCount
784,197,243,graphml/Cogentco.graphml,2,,clustered,0.4;-0.3,12,12,10,2,0,12,2,12,12,2,0,edgeCount
783,197,243,graphml/Cogentco.graphml,2,,clustered,0.4;-0.3,12,8,8,4,6,8,0,8,8,0,4,edgeCount
782,197,243,graphml/Cogentco.graphml,2,,clustered,0.4;-0.3,20,18,17,3,2,18,1,18,18,1,2,edgeCount
781,197,243,graphml/Cogentco.graphml,2,,clustered,0.4;-0.3,11,20,8,3,0,8,0,8,8,0,0,edgeCount
780,197,243,graphml/Cogentco.graphml,2,,clustered,0.4;-0.3,13,28,8,5,0,9,1,9,9,1,0,edgeCount
779,197,243,graphml/Cogentco.graphml,2,,clustered,0.4;-0.3,17,17,16,1,0,17,1,17,17,1,0,edgeCount
778,197,243,graphml/Cogentco.graphml,1,,clustered,0.4;-0.3,10,10,10,0,4,10,0,10,10,0,4,edgeCount
777,197,243,graphml/Cogentco.graphml,2,,clustered,0.4;-0.3,7,7,7,0,0,7,0,7,7,0,0,edgeCount
776,197,243,graphml/Cogentco.graphml,2,,clustered,0.4;-0.3,11,11,8,3,0,11,3,11,11,3,0,edgeCount
775,197,243,graphml/Cogentco.graphml,2,,clustered,0.4;-0.3,12,8,8,4,0,8,0,8,8,0,0,edgeCount
774,197,243,graphml/Cogentco.graphml,2,,clustered,0.4;-0.3,6,6,6,0,0,6,0,6,6,0,0,edgeCount
773,197,243,graphml/Cogentco.graphml,2,,clustered,0.4;-0.3,20,51,13,7,2,13,0,13,13,0,2,edgeCount
772,197,243,graphml/Cogentco.graphml,1,,clustered,0.4;-0.3,15,15,15,0,4,15,0,15,15,0,4,edgeCount
771,197,243,graphml/Cogentco.graphml,2,,clustered,0.4;-0.3,26,26,20,6,0,26,6,26,26,6,0,edgeCount
770,197,243,graphml/Cogentco.graphml,1,,clustered,0.4;-0.3,10,10,10,0,0,10,0,10,10,0,0,edgeCount
769,197,243,graphml/Cogentco.graphml,3,,clustered,0.4;-0.3,21,34,10,11,12,45,35,45,50,35,12,edgeCount
768,197,243,graphml/Cogentco.graphml,1,,clustered,0.4;-0.3,14,14,14,0,0,14,0,14,14,0,0,edgeCount
767,197,243,graphml/Cogentco.graphml,2,,clustered,0.4;-0.3,11,11,11,0,0,11,0,11,11,0,0,edgeCount
766,197,243,graphml/Cogentco.graphml,2,,clustered,0.4;-0.3,15,29,12,3,2,37,25,37,37,25,2,edgeCount
765,197,243,graphml/Cogentco.graphml,2,,clustered,0.4;-0.3,5,5,5,0,0,5,0,5,5,0,0,edgeCount
764,197,243,graphml/Cogentco.graphml,1,,clustered,0.4;-0.3,22,14,14,8,4,-1,-15,22,14,8,4,edgeCount
763,197,243,graphml/Cogentco.graphml,2,,clustered,0.4;-0.3,10,10,10,0,14,10,0,10,10,0,14,edgeCount
762,197,243,graphml/Cogentco.graphml,1,,clustered,0.4;-0.3,7,7,7,0,0,7,0,7,7,0,0,edgeCount
761,197,243,graphml/Cogentco.graphml,2,,clustered,0.4;-0.3,6,6,6,0,0,8,2,6,6,0,0,edgeCount
760,197,243,graphml/Cogentco.graphml,2,,clustered,0.4;-0.3,12,9,9,3,2,9,0,9,9,0,2,edgeCount
759,197,243,graphml/Cogentco.graphml,2,,clustered,0.4;-0.3,28,15,15,13,4,15,0,15,15,0,4,edgeCount
758,197,243,graphml/Cogentco.graphml,2,,clustered,0.4;-0.3,12,22,9,3,2,10,1,12,22,3,2,edgeCount
757,197,243,graphml/Cogentco.graphml,2,,clustered,0.4;-0.3,20,62,6,14,0,6,0,6,6,0,0,edgeCount
756,197,243,graphml/Cogentco.graphml,2,,clustered,0.4;-0.3,17,17,11,6,0,17,6,17,17,6,0,edgeCount
755,197,243,graphml/Cogentco.graphml,2,,clustered,0.4;-0.3,22,22,22,0,0,22,0,22,22,0,0,edgeCount
754,197,243,graphml/Cogentco.graphml,2,,clustered,0.4;-0.3,15,15,15,0,0,15,0,15,15,0,0,edgeCount
753,197,243,graphml/Cogentco.graphml,1,,clustered,0.4;-0.3,12,12,12,0,2,12,0,12,12,0,2,edgeCount
752,197,243,graphml/Cogentco.graphml,3,,clustered,0.4;-0.3,10,14,10,0,0,14,4,14,14,4,0,edgeCount
751,197,243,graphml/Cogentco.graphml,1,,clustered,0.4;-0.3,20,20,20,0,4,20,0,20,20,0,4,edgeCount
750,197,243,graphml/Cogentco.graphml,1,,clustered,0.4;-0.3,28,28,28,0,0,28,0,28,28,0,0,edgeCount
749,197,243,graphml/Cogentco.graphml,2,,clustered,0.4;-0.3,13,13,12,1,0,16,4,13,13,1,0,edgeCount
748,197,243,graphml/Cogentco.graphml,2,,clustered,0.4;-0.3,56,56,20,36,0,56,36,56,56,36,0,edgeCount
747,197,243,graphml/Cogentco.graphml,2,,clustered,0.4;-0.3,13,13,13,0,0,13,0,13,13,0,0,edgeCount
746,197,243,graphml/Cogentco.graphml,2,,clustered,0.4;-0.3,10,10,10,0,2,10,0,10,10,0,2,edgeCount
745,197,243,graphml/Cogentco.graphml,2,,clustered,0.4;-0.3,7,7,7,0,2,7,0,7,7,0,2,edgeCount
744,197,243,graphml/Cogentco.graphml,1,,clustered,0.4;-0.3,11,11,11,0,2,11,0,11,11,0,2,edgeCount
743,197,243,graphml/Cogentco.graphml,1,,clustered,0.4;-0.3,24,24,24,0,4,24,0,24,24,0,4,edgeCount
742,197,243,graphml/Cogentco.graphml,1,,clustered,0.4;-0.3,13,13,13,0,0,13,0,13,13,0,0,edgeCount
741,197,243,graphml/Cogentco.graphml,2,,clustered,0.4;-0.3,12,12,12,0,0,12,0,12,12,0,0,edgeCount
740,197,243,graphml/Cogentco.graphml,1,,clustered,0.4;-0.3,13,14,13,0,2,13,0,13,14,0,2,edgeCount
739,197,243,graphml/Cogentco.graphml,2,,clustered,0.4;-0.3,13,13,13,0,2,13,0,13,13,0,2,edgeCount
738,197,243,graphml/Cogentco.graphml,2,,clustered,0.4;-0.3,8,8,8,0,0,8,0,8,8,0,0,edgeCount
737,197,243,graphml/Cogentco.graphml,2,,clustered,0.4;-0.3,11,11,10,1,0,11,1,11,11,1,0,edgeCount
736,197,243,graphml/Cogentco.graphml,1,,clustered,0.4;-0.3,17,17,17,0,0,17,0,17,17,0,0,edgeCount
735,197,243,graphml/Cogentco.graphml,2,,clustered,0.4;-0.3,4,4,4,0,0,4,0,4,4,0,0,edgeCount
734,197,243,graphml/Cogentco.graphml,2,,clustered,0.4;-0.3,10,10,7,3,0,10,3,10,10,3,0,edgeCount
733,197,243,graphml/Cogentco.graphml,3,,clustered,0.4;-0.3,12,12,8,4,0,23,15,23,23,15,0,edgeCount
732,197,243,graphml/Cogentco.graphml,2,,clustered,0.4;-0.3,10,10,10,0,0,10,0,10,10,0,0,edgeCount
731,197,243,graphml/Cogentco.graphml,2,,clustered,0.4;-0.3,16,10,9,7,0,10,1,10,10,1,0,edgeCount
730,197,243,graphml/Cogentco.graphml,2,,clustered,0.4;-0.3,5,5,5,0,0,18,13,13,5,8,0,edgeCount
729,197,243,graphml/Cogentco.graphml,2,,clustered,0.4;-0.3,15,12,11,4,0,12,1,12,12,1,0,edgeCount
728,197,243,graphml/Cogentco.graphml,3,,clustered,0.4;-0.3,4,16,4,0,2,10,6,10,4,6,2,edgeCount
727,197,243,graphml/Cogentco.graphml,2,,clustered,0.4;-0.3,32,43,13,19,2,32,19,32,43,19,2,edgeCount
726,197,243,graphml/Cogentco.graphml,2,,clustered,0.4;-0.3,20,16,16,4,6,16,0,16,16,0,6,edgeCount
725,197,243,graphml/Cogentco.graphml,3,,clustered,0.4;-0.3,37,37,10,27,2,37,27,37,37,27,2,edgeCount
724,197,243,graphml/Cogentco.graphml,2,,clustered,0.4;-0.3,10,10,9,1,2,10,1,10,10,1,2,edgeCount
723,197,243,graphml/Cogentco.graphml,2,,clustered,0.4;-0.3,20,40,15,5,0,47,32,44,44,29,0,edgeCount
722,197,243,graphml/Cogentco.graphml,2,,clustered,0.4;-0.3,12,11,7,5,0,11,4,11,11,4,0,edgeCount
721,197,243,graphml/Cogentco.graphml,2,,clustered,0.4;-0.3,4,25,4,0,0,8,4,8,8,4,0,edgeCount
720,197,243,graphml/Cogentco.graphml,1,,clustered,0.4;-0.3,18,18,18,0,0,18,0,18,18,0,0,edgeCount
719,197,243,graphml/Cogentco.graphml,2,,clustered,0.4;-0.3,22,22,19,3,6,60,41,60,60,41,6,edgeCount
718,197,243,graphml/Cogentco.graphml,2,,clustered,0.4;-0.3,22,19,13,9,0,19,6,19,19,6,0,edgeCount
717,197,243,graphml/Cogentco.graphml,3,,clustered,0.4;-0.3,10,10,10,0,2,10,0,10,10,0,2,edgeCount
716,197,243,graphml/Cogentco.graphml,2,,clustered,0.4;-0.3,32,10,8,24,2,10,2,10,10,2,2,edgeCount
715,197,243,graphml/Cogentco.graphml,2,,clustered,0.4;-0.3,28,8,5,23,2,8,3,28,8,23,2,edgeCount
714,197,243,graphml/Cogentco.graphml,2,,clustered,0.4;-0.3,12,18,7,5,0,7,0,7,7,0,0,edgeCount
713,197,243,graphml/Cogentco.graphml,2,,clustered,0.4;-0.3,22,14,14,8,2,14,0,14,14,0,2,edgeCount
712,197,243,graphml/Cogentco.graphml,2,,clustered,0.4;-0.3,19,13,5,14,2,5,0,5,5,0,2,edgeCount
711,197,243,graphml/Cogentco.graphml,2,,clustered,0.4;-0.3,25,18,15,10,2,18,3,18,18,3,2,edgeCount
710,197,243,graphml/Cogentco.graphml,1,,clustered,0.4;-0.3,11,11,11,0,0,11,0,11,11,0,0,edgeCount
709,197,243,graphml/Cogentco.graphml,2,,clustered,0.4;-0.3,8,8,7,1,0,8,1,8,8,1,0,edgeCount
708,197,243,graphml/Cogentco.graphml,2,,clustered,0.4;-0.3,16,16,16,0,0,16,0,16,16,0,0,edgeCount
707,197,243,graphml/Cogentco.graphml,2,,clustered,0.4;-0.3,11,11,10,1,0,11,1,11,11,1,0,edgeCount
706,197,243,graphml/Cogentco.graphml,1,,clustered,0.4;-0.3,9,9,9,0,0,9,0,9,9,0,0,edgeCount
705,197,243,graphml/Cogentco.graphml,2,,clustered,0.4;-0.3,22,22,20,2,0,22,2,22,22,2,0,edgeCount
704,197,243,graphml/Cogentco.graphml,2,,clustered,0.4;-0.3,9,19,8,1,2,21,13,21,21,13,2,edgeCount
703,197,243,graphml/Cogentco.graphml,2,,clustered,0.4;-0.3,17,22,12,5,4,33,21,33,33,21,4,edgeCount
702,197,243,graphml/Cogentco.graphml,1,,clustered,0.4;-0.3,13,13,13,0,0,13,0,13,13,0,0,edgeCount
701,197,243,graphml/Cogentco.graphml,2,,clustered,0.4;-0.3,22,11,11,11,2,11,0,11,11,0,2,edgeCount
700,197,243,graphml/Cogentco.graphml,1,,clustered,0.4;-0.3,10,10,10,0,2,10,0,10,10,0,2,edgeCount
699,197,243,graphml/Cogentco.graphml,1,,clustered,0.4;-0.3,5,5,5,0,2,5,0,5,5,0,2,edgeCount
698,197,243,graphml/Cogentco.graphml,2,,clustered,0.4;-0.3,5,5,4,1,0,5,1,5,5,1,0,edgeCount
697,197,243,graphml/Cogentco.graphml,1,,clustered,0.4;-0.3,16,16,16,0,0,16,0,16,16,0,0,edgeCount
696,197,243,graphml/Cogentco.graphml,2,,clustered,0.4;-0.3,9,5,5,4,0,5,0,5,5,0,0,edgeCount
695,197,243,graphml/Cogentco.graphml,1,,clustered,0.4;-0.3,21,21,21,0,2,21,0,21,21,0,2,edgeCount
694,197,243,graphml/Cogentco.graphml,2,,clustered,0.4;-0.3,11,11,7,4,0,11,4,11,11,4,0,edgeCount
693,197,243,graphml/Cogentco.graphml,1,,clustered,0.4;-0.3,5,11,5,0,2,5,0,5,11,0,2,edgeCount
692,197,243,graphml/Cogentco.graphml,2,,clustered,0.4;-0.3,16,16,13,3,0,19,6,16,16,3,0,edgeCount
691,197,243,graphml/Cogentco.graphml,2,,clustered,0.4;-0.3,11,15,6,5,0,6,0,6,6,0,0,edgeCount
690,197,243,graphml/Cogentco.graphml,2,,clustered,0.4;-0.3,10,10,10,0,0,10,0,10,10,0,0,edgeCount
689,197,243,graphml/Cogentco.graphml,2,,clustered,0.4;-0.3,13,20,7,6,4,7,0,7,7,0,4,edgeCount
688,197,243,graphml/Cogentco.graphml,2,,clustered,0.4;-0.3,16,26,15,1,2,40,25,40,40,25,2,edgeCount
687,197,243,graphml/Cogentco.graphml,1,,clustered,0.4;-0.3,10,10,10,0,0,10,0,10,10,0,0,edgeCount
686,197,243,graphml/Cogentco.graphml,1,,clustered,0.4;-0.3,5,5,5,0,4,5,0,5,5,0,4,edgeCount
685,197,243,graphml/Cogentco.graphml,3,,clustered,0.4;-0.3,11,11,11,0,0,11,0,11,11,0,0,edgeCount
684,197,243,graphml/Cogentco.graphml,2,,clustered,0.4;-0.3,15,15,14,1,0,15,1,15,15,1,0,edgeCount
683,197,243,graphml/Cogentco.graphml,2,,clustered,0.4;-0.3,16,16,15,1,0,16,1,16,16,1,0,edgeCount
682,197,243,graphml/Cogentco.graphml,2,,clustered,0.4;-0.3,10,10,9,1,0,10,1,10,10,1,0,edgeCount
681,197,243,graphml/Cogentco.graphml,2,,clustered,0.4;-0.3,51,13,13,38,2,13,0,13,13,0,2,edgeCount
680,197,243,graphml/Cogentco.graphml,2,,clustered,0.4;-0.3,12,12,12,0,0,12,0,12,12,0,0,edgeCount
679,197,243,graphml/Cogentco.graphml,2,,clustered,0.4;-0.3,4,4,4,0,0,4,0,4,4,0,0,edgeCount
678,197,243,graphml/Cogentco.graphml,1,,clustered,0.4;-0.3,12,12,12,0,0,12,0,12,12,0,0,edgeCount
677,197,243,graphml/Cogentco.graphml,2,,clustered,0.4;-0.3,18,17,10,8,2,15,5,15,15,5,2,edgeCount
676,197,243,graphml/Cogentco.graphml,2,,clustered,0.4;-0.3,21,12,12,9,0,12,0,12,12,0,0,edgeCount
675,197,243,graphml/Cogentco.graphml,1,,clustered,0.4;-0.3,24,24,24,0,0,24,0,24,24,0,0,edgeCount
674,197,243,graphml/Cogentco.graphml,2,,clustered,0.4;-0.3,6,6,4,2,0,4,0,4,4,0,0,edgeCount
673,197,243,graphml/Cogentco.graphml,2,,clustered,0.4;-0.3,5,5,5,0,0,5,0,5,5,0,0,edgeCount
672,197,243,graphml/Cogentco.graphml,2,,clustered,0.4;-0.3,28,6,6,22,2,6,0,6,6,0,2,edgeCount
671,197,243,graphml/Cogentco.graphml,1,,clustered,0.4;-0.3,11,11,11,0,0,11,0,11,11,0,0,edgeCount
670,197,243,graphml/Cogentco.graphml,1,,clustered,0.4;-0.3,14,14,14,0,0,14,0,14,14,0,0,edgeCount
669,197,243,graphml/Cogentco.graphml,2,,clustered,0.4;-0.3,13,11,11,2,2,28,17,13,11,2,2,edgeCount
668,197,243,graphml/Cogentco.graphml,2,,clustered,0.4;-0.3,16,16,12,4,2,16,4,16,16,4,2,edgeCount
667,197,243,graphml/Cogentco.graphml,1,,clustered,0.4;-0.3,10,10,10,0,0,10,0,10,10,0,0,edgeCount
666,197,243,graphml/Cogentco.graphml,2,,clustered,0.4;-0.3,14,52,13,1,0,30,17,30,30,17,0,edgeCount
665,197,243,graphml/Cogentco.graphml,1,,clustered,0.4;-0.3,24,24,24,0,0,24,0,24,24,0,0,edgeCount
664,197,243,graphml/Cogentco.graphml,2,,clustered,0.4;-0.3,6,6,6,0,0,6,0,6,6,0,0,edgeCount
663,197,243,graphml/Cogentco.graphml,2,,clustered,0.4;-0.3,46,46,14,32,0,46,32,46,46,32,0,edgeCount
662,197,243,graphml/Cogentco.graphml,2,,clustered,0.4;-0.3,15,15,15,0,2,15,0,15,15,0,2,edgeCount
661,197,243,graphml/Cogentco.graphml,2,,clustered,0.4;-0.3,12,12,12,0,0,12,0,12,12,0,0,edgeCount
660,197,243,graphml/Cogentco.graphml,2,,clustered,0.4;-0.3,8,8,8,0,0,8,0,8,8,0,0,edgeCount
659,197,243,graphml/Cogentco.graphml,1,,clustered,0.4;-0.3,16,16,16,0,0,16,0,16,16,0,0,edgeCount
658,197,243,graphml/Cogentco.graphml,2,,clustered,0.4;-0.3,23,23,20,3,0,23,3,23,23,3,0,edgeCount
657,197,243,graphml/Cogentco.graphml,1,,clustered,0.4;-0.3,6,26,6,0,4,6,0,6,26,0,4,edgeCount
656,197,243,graphml/Cogentco.graphml,2,,clustered,0.4;-0.3,10,10,10,0,0,10,0,10,10,0,0,edgeCount
655,197,243,graphml/Cogentco.graphml,1,,clustered,0.4;-0.3,7,7,7,0,2,7,0,7,7,0,2,edgeCount
654,197,243,graphml/Cogentco.graphml,2,,clustered,0.4;-0.3,14,14,13,1,0,14,1,14,14,1,0,edgeCount
653,197,243,graphml/Cogentco.graphml,1,,clustered,0.4;-0.3,11,22,11,0,2,11,0,11,22,0,2,edgeCount
652,197,243,graphml/Cogentco.graphml,2,,clustered,0.4;-0.3,9,9,5,4,0,5,0,5,5,0,0,edgeCount
651,197,243,graphml/Cogentco.graphml,3,,clustered,0.4;-0.3,39,6,5,34,4,5,0,5,6,0,4,edgeCount
650,197,243,graphml/Cogentco.graphml,2,,clustered,0.4;-0.3,5,5,5,0,0,5,0,5,5,0,0,edgeCount
649,197,243,graphml/Cogentco.graphml,2,,clustered,0.4;-0.3,21,21,21,0,0,21,0,21,21,0,0,edgeCount
648,197,243,graphml/Cogentco.graphml,2,,clustered,0.4;-0.3,16,16,13,3,0,16,3,16,16,3,0,edgeCount
647,197,243,graphml/Cogentco.graphml,2,,clustered,0.4;-0.3,18,6,3,15,4,6,3,6,6,3,4,edgeCount
646,197,243,graphml/Cogentco.graphml,2,,clustered,0.4;-0.3,18,9,9,9,0,9,0,9,9,0,0,edgeCount
645,197,243,graphml/Cogentco.graphml,2,,clustered,0.4;-0.3,6,22,5,1,4,5,0,5,5,0,4,edgeCount
644,197,243,graphml/Cogentco.graphml,2,,clustered,0.4;-0.3,20,21,15,5,2,56,41,56,56,41,2,edgeCount
643,197,243,graphml/Cogentco.graphml,2,,clustered,0.4;-0.3,4,11,4,0,2,4,0,4,4,0,2,edgeCount
642,197,243,graphml/Cogentco.graphml,3,,clustered,0.4;-0.3,6,6,6,0,0,6,0,6,6,0,0,edgeCount
641,197,243,graphml/Cogentco.graphml,2,,clustered,0.4;-0.3,9,9,9,0,0,9,0,9,9,0,0,edgeCount
640,197,243,graphml/Cogentco.graphml,2,,clustered,0.4;-0.3,4,4,4,0,0,4,0,4,4,0,0,edgeCount
639,197,243,graphml/Cogentco.graphml,2,,clustered,0.4;-0.3,20,13,13,7,0,13,0,13,13,0,0,edgeCount
638,197,243,graphml/Cogentco.graphml,2,,clustered,0.4;-0.3,3,3,3,0,0,3,0,3,3,0,0,edgeCount
637,197,243,graphml/Cogentco.graphml,2,,clustered,0.4;-0.3,10,10,9,1,0,10,1,10,10,1,0,edgeCount
636,197,243,graphml/Cogentco.graphml,1,,clustered,0.4;-0.3,9,9,9,0,0,9,0,9,9,0,0,edgeCount
635,197,243,graphml/Cogentco.graphml,1,,clustered,0.4;-0.3,14,14,14,0,0,14,0,14,14,0,0,edgeCount
634,197,243,graphml/Cogentco.graphml,1,,clustered,0.4;-0.3,7,7,7,0,2,7,0,7,7,0,2,edgeCount
633,197,243,graphml/Cogentco.graphml,2,,clustered,0.4;-0.3,18,18,18,0,0,18,0,18,18,0,0,edgeCount
632,197,243,graphml/Cogentco.graphml,2,,clustered,0.4;-0.3,14,14,14,0,0,14,0,14,14,0,0,edgeCount
631,197,243,graphml/Cogentco.graphml,2,,clustered,0.4;-0.3,12,12,12,0,0,12,0,12,12,0,0,edgeCount
630,197,243,graphml/Cogentco.graphml,1,,clustered,0.4;-0.3,11,11,11,0,4,11,0,11,11,0,4,edgeCount
629,197,243,graphml/Cogentco.graphml,2,,clustered,0.4;-0.3,70,70,21,49,0,70,49,70,70,49,0,edgeCount
628,197,243,graphml/Cogentco.graphml,1,,clustered,0.4;-0.3,17,37,17,0,2,-1,-18,17,37,0,2,edgeCount
627,197,243,graphml/Cogentco.graphml,2,,clustered,0.4;-0.3,11,11,11,0,0,11,0,11,11,0,0,edgeCount
626,197,243,graphml/Cogentco.graphml,2,,clustered,0.4;-0.3,8,5,5,3,14,5,0,5,5,0,14,edgeCount
625,197,243,graphml/Cogentco.graphml,2,,clustered,0.4;-0.3,27,9,9,18,2,9,0,9,9,0,2,edgeCount
624,197,243,graphml/Cogentco.graphml,2,,clustered,0.4;-0.3,22,22,8,14,0,20,12,20,20,12,0,edgeCount
623,197,243,graphml/Cogentco.graphml,2,,clustered,0.4;-0.3,23,17,16,7,0,17,1,17,17,1,0,edgeCount
622,197,243,graphml/Cogentco.graphml,2,,clustered,0.4;-0.3,8,8,8,0,0,8,0,8,8,0,0,edgeCount
621,197,243,graphml/Cogentco.graphml,2,,clustered,0.4;-0.3,15,15,14,1,0,15,1,15,15,1,0,edgeCount
620,197,243,graphml/Cogentco.graphml,2,,clustered,0.4;-0.3,19,19,16,3,0,19,3,19,19,3,0,edgeCount
619,197,243,graphml/Cogentco.graphml,2,,clustered,0.4;-0.3,13,20,7,6,4,7,0,7,7,0,4,edgeCount
618,197,243,graphml/Cogentco.graphml,1,,clustered,0.4;-0.3,10,11,10,0,2,10,0,10,11,0,2,edgeCount
617,197,243,graphml/Cogentco.graphml,1,,clustered,0.4;-0.3,13,13,13,0,0,13,0,13,13,0,0,edgeCount
616,197,243,graphml/Cogentco.graphml,2,,clustered,0.4;-0.3,3,3,3,0,0,8,5,3,3,0,0,edgeCount
615,197,243,graphml/Cogentco.graphml,2,,clustered,0.4;-0.3,19,19,16,3,6,19,3,19,19,3,6,edgeCount
614,197,243,graphml/Cogentco.graphml,3,,clustered,0.4;-0.3,13,11,9,4,0,25,16,25,25,16,0,edgeCount
613,197,243,graphml/Cogentco.graphml,2,,clustered,0.4;-0.3,19,21,12,7,0,19,7,19,19,7,0,edgeCount
612,197,243,graphml/Cogentco.graphml,1,,clustered,0.4;-0.3,7,7,7,0,0,7,0,7,7,0,0,edgeCount
611,197,243,graphml/Cogentco.graphml,2,,clustered,0.4;-0.3,19,19,16,3,2,19,3,19,19,3,2,edgeCount
610,197,243,graphml/Cogentco.graphml,2,,clustered,0.4;-0.3,10,18,10,0,6,22,12,22,23,12,6,edgeCount
609,197,243,graphml/Cogentco.graphml,2,,clustered,0.4;-0.3,6,5,5,1,0,5,0,5,5,0,0,edgeCount
608,197,243,graphml/Cogentco.graphml,1,,clustered,0.4;-0.3,10,22,10,0,2,10,0,10,22,0,2,edgeCount
607,197,243,graphml/Cogentco.graphml,2,,clustered,0.4;-0.3,8,5,5,3,0,5,0,5,5,0,0,edgeCount
606,197,243,graphml/Cogentco.graphml,2,,clustered,0.4;-0.3,8,8,8,0,0,8,0,8,8,0,0,edgeCount
605,197,243,graphml/Cogentco.graphml,2,,clustered,0.4;-0.3,8,8,3,5,0,8,5,8,8,5,0,edgeCount
604,197,243,graphml/Cogentco.graphml,1,,clustered,0.4;-0.3,15,15,15,0,8,15,0,15,15,0,8,edgeCount
603,197,243,graphml/Cogentco.graphml,1,,clustered,0.4;-0.3,20,20,20,0,0,20,0,20,20,0,0,edgeCount
602,197,243,graphml/Cogentco.graphml,2,,clustered,0.4;-0.3,13,13,13,0,0,13,0,13,13,0,0,edgeCount
601,197,243,graphml/Cogentco.graphml,1,,clustered,0.4;-0.3,21,21,9,12,2,-1,-10,21,21,12,2,edgeCount
600,197,243,graphml/Cogentco.graphml,2,,clustered,0.4;-0.3,18,6,6,12,2,6,0,18,6,12,2,edgeCount
599,197,243,graphml/Cogentco.graphml,3,,clustered,0.4;-0.3,13,13,12,1,0,13,1,13,13,1,0,edgeCount
598,197,243,graphml/Cogentco.graphml,1,,clustered,0.4;-0.3,24,24,24,0,0,24,0,24,24,0,0,edgeCount
597,197,243,graphml/Cogentco.graphml,2,,clustered,0.4;-0.3,32,32,10,22,2,30,20,32,32,22,2,edgeCount
596,197,243,graphml/Cogentco.graphml,1,,clustered,0.4;-0.3,9,9,9,0,2,9,0,9,9,0,2,edgeCount
595,197,243,graphml/Cogentco.graphml,2,,clustered,0.4;-0.3,8,8,8,0,0,8,0,8,8,0,0,edgeCount
594,197,243,graphml/Cogentco.graphml,2,,clustered,0.4;-0.3,16,22,15,1,0,15,0,15,15,0,0,edgeCount
593,197,243,graphml/Cogentco.graphml,1,,clustered,0.4;-0.3,16,16,16,0,0,16,0,16,16,0,0,edgeCount
592,197,243,graphml/Cogentco.graphml,2,,clustered,0.4;-0.3,54,54,19,35,0,54,35,54,54,35,0,edgeCount
591,197,243,graphml/Cogentco.graphml,2,,clustered,0.4;-0.3,6,4,4,2,0,4,0,4,4,0,0,edgeCount
590,197,243,graphml/Cogentco.graphml,2,,clustered,0.4;-0.3,13,9,9,4,2,9,0,9,9,0,2,edgeCount
589,197,243,graphml/Cogentco.graphml,2,,clustered,0.4;-0.3,25,15,15,10,0,15,0,15,15,0,0,edgeCount
588,197,243,graphml/Cogentco.graphml,2,,clustered,0.4;-0.3,8,8,8,0,2,8,0,8,8,0,2,edgeCount
587,197,243,graphml/Cogentco.graphml,1,,clustered,0.4;-0.3,9,9,9,0,0,9,0,9,9,0,0,edgeCount
586,197,243,graphml/Cogentco.graphml,2,,clustered,0.4;-0.3,11,6,6,5,0,6,0,6,6,0,0,edgeCount
585,197,243,graphml/Cogentco.graphml,2,,clustered,0.4;-0.3,12,12,12,0,0,12,0,12,12,0,0,edgeCount
584,197,243,graphml/Cogentco.graphml,2,,clustered,0.4;-0.3,8,8,8,0,0,8,0,8,8,0,0,edgeCount
583,197,243,graphml/Cogentco.graphml,2,,clustered,0.4;-0.3,17,17,17,0,2,17,0,17,17,0,2,edgeCount
582,197,243,graphml/Cogentco.graphml,1,,clustered,0.4;-0.3,12,30,12,0,6,12,0,12,30,0,6,edgeCount
581,197,243,graphml/Cogentco.graphml,1,,clustered,0.4;-0.3,17,17,17,0,2,17,0,17,17,0,2,edgeCount
580,197,243,graphml/Cogentco.graphml,2,,clustered,0.4;-0.3,54,12,12,42,2,12,0,12,12,0,2,edgeCount
579,197,243,graphml/Cogentco.graphml,2,,clustered,0.4;-0.3,12,12,9,3,0,12,3,12,12,3,0,edgeCount
578,197,243,graphml/Cogentco.graphml,2,,clustered,0.4;-0.3,16,14,11,5,0,14,3,14,14,3,0,edgeCount
577,197,243,graphml/Cogentco.graphml,2,,clustered,0.4;-0.3,12,19,11,1,0,11,0,11,11,0,0,edgeCount
576,197,243,graphml/Cogentco.graphml,2,,clustered,0.4;-0.3,38,16,16,22,2,16,0,16,16,0,2,edgeCount
575,197,243,graphml/Cogentco.graphml,2,,clustered,0.4;-0.3,9,6,6,3,0,6,0,6,6,0,0,edgeCount
574,197,243,graphml/Cogentco.graphml,2,,clustered,0.4;-0.3,13,13,12,1,0,13,1,13,13,1,0,edgeCount
573,197,243,graphml/Cogentco.graphml,3,,clustered,0.4;-0.3,15,10,10,5,0,10,0,10,10,0,0,edgeCount
572,197,243,graphml/Cogentco.graphml,1,,clustered,0.4;-0.3,10,22,10,0,2,10,0,10,22,0,2,edgeCount
571,197,243,graphml/Cogentco.graphml,1,,clustered,0.4;-0.3,7,7,7,0,0,7,0,7,7,0,0,edgeCount
570,197,243,graphml/Cogentco.graphml,1,,clustered,0.4;-0.3,5,5,5,0,0,5,0,5,5,0,0,edgeCount
569,197,243,graphml/Cogentco.graphml,1,,clustered,0.4;-0.3,9,9,9,0,4,9,0,9,9,0,4,edgeCount
568,197,243,graphml/Cogentco.graphml,2,,clustered,0.4;-0.3,13,29,13,0,2,13,0,13,13,0,2,edgeCount
567,197,243,graphml/Cogentco.graphml,2,,clustered,0.4;-0.3,13,25,5,8,2,5,0,5,23,0,2,edgeCount
566,197,243,graphml/Cogentco.graphml,3,,clustered,0.4;-0.3,2,2,2,0,0,2,0,2,2,0,0,edgeCount
565,197,243,graphml/Cogentco.graphml,1,,clustered,0.4;-0.3,12,12,12,0,0,12,0,12,12,0,0,edgeCount
564,197,243,graphml/Cogentco.graphml,3,,clustered,0.4;-0.3,6,6,6,0,0,6,0,6,6,0,0,edgeCount
563,197,243,graphml/Cogentco.graphml,2,,clustered,0.4;-0.3,20,36,13,7,2,19,6,19,19,6,2,edgeCount
562,197,243,graphml/Cogentco.graphml,2,,clustered,0.4;-0.3,5,5,5,0,0,5,0,5,5,0,0,edgeCount
561,197,243,graphml/Cogentco.graphml,1,,clustered,0.4;-0.3,24,24,24,0,2,24,0,24,24,0,2,edgeCount
560,197,243,graphml/Cogentco.graphml,1,,clustered,0.4;-0.3,18,18,10,8,4,-1,-11,18,18,8,4,edgeCount
559,197,243,graphml/Cogentco.graphml,2,,clustered,0.4;-0.3,14,12,11,3,2,12,1,12,12,1,2,edgeCount
558,197,243,graphml/Cogentco.graphml,2,,clustered,0.4;-0.3,24,36,14,10,2,44,30,44,48,30,2,edgeCount
557,197,243,graphml/Cogentco.graphml,2,,clustered,0.4;-0.3,17,17,16,1,0,17,1,17,17,1,0,edgeCount
556,197,243,graphml/Cogentco.graphml,2,,clustered,0.4;-0.3,16,40,14,2,2,40,26,40,40,26,2,edgeCount
555,197,243,graphml/Cogentco.graphml,2,,clustered,0.4;-0.3,10,4,4,6,0,4,0,4,4,0,0,edgeCount
554,197,243,graphml/Cogentco.graphml,2,,clustered,0.4;-0.3,16,28,9,7,0,11,2,11,11,2,0,edgeCount
553,197,243,graphml/Cogentco.graphml,2,,clustered,0.4;-0.3,7,7,4,3,2,7,3,7,7,3,2,edgeCount
552,197,243,graphml/Cogentco.graphml,2,,clustered,0.4;-0.3,14,14,14,0,2,14,0,14,14,0,2,edgeCount
551,197,243,graphml/Cogentco.graphml,2,,clustered,0.4;-0.3,8,8,6,2,0,8,2,8,8,2,0,edgeCount
550,197,243,graphml/Cogentco.graphml,2,,clustered,0.4;-0.3,8,8,8,0,2,8,0,8,8,0,2,edgeCount
549,197,243,graphml/Cogentco.graphml,2,,clustered,0.4;-0.3,15,15,15,0,0,15,0,15,15,0,0,edgeCount
548,197,243,graphml/Cogentco.graphml,1,,clustered,0.4;-0.3,7,7,7,0,0,7,0,7,7,0,0,edgeCount
547,197,243,graphml/Cogentco.graphml,2,,clustered,0.4;-0.3,15,15,11,4,2,15,4,15,15,4,2,edgeCount
546,197,243,graphml/Cogentco.graphml,2,,clustered,0.4;-0.3,9,9,9,0,0,9,0,9,9,0,0,edgeCount
545,197,243,graphml/Cogentco.graphml,2,,clustered,0.4;-0.3,3,3,3,0,0,3,0,3,3,0,0,edgeCount
544,197,243,graphml/Cogentco.graphml,2,,clustered,0.4;-0.3,23,26,18,5,0,18,0,18,18,0,0,edgeCount
543,197,243,graphml/Cogentco.graphml,2,,clustered,0.4;-0.3,9,9,9,0,0,9,0,9,9,0,0,edgeCount
542,197,243,graphml/Cogentco.graphml,1,,clustered,0.4;-0.3,13,13,13,0,2,13,0,13,13,0,2,edgeCount
541,197,243,graphml/Cogentco.graphml,2,,clustered,0.4;-0.3,62,62,27,35,2,62,35,62,62,35,2,edgeCount
540,197,243,graphml/Cogentco.graphml,1,,clustered,0.4;-0.3,10,10,10,0,2,10,0,10,10,0,2,edgeCount
539,197,243,graphml/Cogentco.graphml,2,,clustered,0.4;-0.3,16,16,16,0,0,16,0,16,16,0,0,edgeCount
538,197,243,graphml/Cogentco.graphml,2,,clustered,0.4;-0.3,20,15,15,5,2,46,31,15,15,0,2,edgeCount
537,197,243,graphml/Cogentco.graphml,2,,clustered,0.4;-0.3,9,9,9,0,0,28,19,28,28,19,0,edgeCount
536,197,243,graphml/Cogentco.graphml,2,,clustered,0.4;-0.3,16,16,12,4,2,16,4,16,16,4,2,edgeCount
535,197,243,graphml/Cogentco.graphml,2,,clustered,0.4;-0.3,29,7,7,22,4,7,0,7,7,0,4,edgeCount
534,197,243,graphml/Cogentco.graphml,1,,clustered,0.4;-0.3,15,15,15,0,0,15,0,15,15,0,0,edgeCount
533,197,243,graphml/Cogentco.graphml,2,,clustered,0.4;-0.3,15,15,15,0,0,15,0,15,15,0,0,edgeCount
532,197,243,graphml/Cogentco.graphml,2,,clustered,0.4;-0.3,9,8,8,1,0,8,0,8,8,0,0,edgeCount
531,197,243,graphml/Cogentco.graphml,2,,clustered,0.4;-0.3,16,16,14,2,0,16,2,16,16,2,0,edgeCount
530,197,243,graphml/Cogentco.graphml,1,,clustered,0.4;-0.3,8,8,8,0,0,8,0,8,8,0,0,edgeCount
529,197,243,graphml/Cogentco.graphml,2,,clustered,0.4;-0.3,14,14,14,0,2,14,0,14,14,0,2,edgeCount
528,197,243,graphml/Cogentco.graphml,2,,clustered,0.4;-0.3,23,41,20,3,2,55,35,55,57,35,2,edgeCount
527,197,243,graphml/Cogentco.graphml,2,,clustered,0.4;-0.3,7,7,7,0,0,7,0,7,7,0,0,edgeCount
526,197,243,graphml/Cogentco.graphml,1,,clustered,0.4;-0.3,12,12,12,0,2,12,0,12,12,0,2,edgeCount
525,197,243,graphml/Cogentco.graphml,1,,clustered,0.4;-0.3,16,16,16,0,0,16,0,16,16,0,0,edgeCount
524,197,243,graphml/Cogentco.graphml,2,,clustered,0.4;-0.3,6,24,6,0,2,6,0,6,24,0,2,edgeCount
523,197,243,graphml/Cogentco.graphml,2,,clustered,0.4;-0.3,13,13,13,0,2,13,0,13,13,0,2,edgeCount
522,197,243,graphml/Cogentco.graphml,2,,clustered,0.4;-0.3,18,24,13,5,2,16,3,18,24,5,2,edgeCount
521,197,243,graphml/Cogentco.graphml,2,,clustered,0.4;-0.3,19,19,18,1,0,19,1,19,19,1,0,edgeCount
520,197,243,graphml/Cogentco.graphml,2,,clustered,0.4;-0.3,9,6,6,3,0,6,0,6,6,0,0,edgeCount
519,197,243,graphml/Cogentco.graphml,1,,clustered,0.4;-0.3,24,24,24,0,0,24,0,24,24,0,0,edgeCount
518,197,243,graphml/Cogentco.graphml,3,,clustered,0.4;-0.3,5,4,4,1,0,4,0,4,4,0,0,edgeCount
517,197,243,graphml/Cogentco.graphml,2,,clustered,0.4;-0.3,13,13,9,4,0,13,4,13,13,4,0,edgeCount
516,197,243,graphml/Cogentco.graphml,2,,clustered,0.4;-0.3,2,2,2,0,2,2,0,2,2,0,2,edgeCount
515,197,243,graphml/Cogentco.graphml,1,,clustered,0.4;-0.3,14,14,14,0,0,14,0,14,14,0,0,edgeCount
514,197,243,graphml/Cogentco.graphml,2,,clustered,0.4;-0.3,18,18,14,4,0,18,4,18,18,4,0,edgeCount
513,197,243,graphml/Cogentco.graphml,2,,clustered,0.4;-0.3,10,10,8,2,0,10,2,10,10,2,0,edgeCount
512,197,243,graphml/Cogentco.graphml,2,,clustered,0.4;-0.3,16,15,11,5,0,11,0,11,11,0,0,edgeCount
511,197,243,graphml/Cogentco.graphml,1,,clustered,0.4;-0.3,59,36,25,34,4,-1,-26,59,36,34,4,edgeCount
510,197,243,graphml/Cogentco.graphml,1,,clustered,0.4;-0.3,5,5,5,0,0,5,0,5,5,0,0,edgeCount
509,197,243,graphml/Cogentco.graphml,1,,clustered,0.4;-0.3,17,17,17,0,0,17,0,17,17,0,0,edgeCount
508,197,243,graphml/Cogentco.graphml,1,,clustered,0.4;-0.3,12,12,12,0,2,12,0,12,12,0,2,edgeCount
507,197,243,graphml/Cogentco.graphml,2,,clustered,0.4;-0.3,19,35,16,3,2,45,29,45,51,29,2,edgeCount
506,197,243,graphml/Cogentco.graphml,1,,clustered,0.4;-0.3,13,13,13,0,0,13,0,13,13,0,0,edgeCount
505,197,243,graphml/Cogentco.graphml,2,,clustered,0.4;-0.3,9,6,4,5,2,6,2,6,6,2,2,edgeCount
504,197,243,graphml/Cogentco.graphml,1,,clustered,0.4;-0.3,10,10,10,0,0,10,0,10,10,0,0,edgeCount
503,197,243,graphml/Cogentco.graphml,2,,clustered,0.4;-0.3,7,16,7,0,2,17,10,17,17,10,2,edgeCount
502,197,243,graphml/Cogentco.graphml,1,,clustered,0.4;-0.3,7,7,7,0,0,7,0,7,7,0,0,edgeCount
501,197,243,graphml/Cogentco.graphml,1,,clustered,0.4;-0.3,9,19,9,0,2,9,0,9,19,0,2,edgeCount
500,197,243,graphml/Cogentco.graphml,2,,clustered,0.4;-0.3,13,13,5,8,2,5,0,5,7,0,2,edgeCount
499,197,243,graphml/Cogentco.graphml,1,,clustered,0.4;-0.3,19,19,8,11,2,-1,-9,19,19,11,2,edgeCount
498,197,243,graphml/Cogentco.graphml,2,,clustered,0.4;-0.3,6,6,6,0,0,6,0,6,6,0,0,edgeCount
497,197,243,graphml/Cogentco.graphml,2,,clustered,0.4;-0.3,9,9,9,0,2,9,0,9,9,0,2,edgeCount
496,197,243,graphml/Cogentco.graphml,2,,clustered,0.4;-0.3,7,7,7,0,0,7,0,7,7,0,0,edgeCount
495,197,243,graphml/Cogentco.graphml,2,,clustered,0.4;-0.3,11,11,11,0,0,11,0,11,11,0,0,edgeCount
494,197,243,graphml/Cogentco.graphml,2,,clustered,0.4;-0.3,12,24,11,1,4,22,11,22,22,11,4,edgeCount
493,197,243,graphml/Cogentco.graphml,2,,clustered,0.4;-0.3,19,31,15,4,2,18,3,18,18,3,2,edgeCount
492,197,243,graphml/Cogentco.graphml,1,,clustered,0.4;-0.3,13,13,13,0,0,13,0,13,13,0,0,edgeCount
491,197,243,graphml/Cogentco.graphml,3,,clustered,0.4;-0.3,34,34,12,22,0,34,22,34,34,22,0,edgeCount
490,197,243,graphml/Cogentco.graphml,2,,clustered,0.4;-0.3,22,22,22,0,0,22,0,22,22,0,0,edgeCount
489,197,243,graphml/Cogentco.graphml,1,,clustered,0.4;-0.3,10,10,10,0,0,10,0,10,10,0,0,edgeCount
488,197,243,graphml/Cogentco.graphml,2,,clustered,0.4;-0.3,5,5,5,0,0,5,0,5,5,0,0,edgeCount
487,197,243,graphml/Cogentco.graphml,1,,clustered,0.4;-0.3,9,9,9,0,2,9,0,9,9,0,2,edgeCount
486,197,243,graphml/Cogentco.graphml,2,,clustered,0.4;-0.3,13,13,13,0,0,13,0,13,13,0,0,edgeCount
485,197,243,graphml/Cogentco.graphml,2,,clustered,0.4;-0.3,13,13,12,1,0,13,1,13,13,1,0,edgeCount
484,197,243,graphml/Cogentco.graphml,2,,clustered,0.4;-0.3,13,13,13,0,0,13,0,13,13,0,0,edgeCount
483,197,243,graphml/Cogentco.graphml,2,,clustered,0.4;-0.3,16,16,14,2,2,42,28,42,42,28,2,edgeCount
482,197,243,graphml/Cogentco.graphml,2,,clustered,0.4;-0.3,13,15,12,1,2,13,1,13,13,1,2,edgeCount
481,197,243,graphml/Cogentco.graphml,1,,clustered,0.4;-0.3,9,9,9,0,2,9,0,9,9,0,2,edgeCount
480,197,243,graphml/Cogentco.graphml,2,,clustered,0.4;-0.3,4,4,4,0,0,4,0,4,4,0,0,edgeCount
479,197,243,graphml/Cogentco.graphml,1,,clustered,0.4;-0.3,8,9,8,0,8,8,0,8,9,0,8,edgeCount
478,197,243,graphml/Cogentco.graphml,1,,clustered,0.4;-0.3,15,15,15,0,2,15,0,15,15,0,2,edgeCount
477,197,243,graphml/Cogentco.graphml,1,,clustered,0.4;-0.3,6,6,6,0,0,6,0,6,6,0,0,edgeCount
476,197,243,graphml/Cogentco.graphml,2,,clustered,0.4;-0.3,6,8,5,1,2,10,5,10,10,5,2,edgeCount
475,197,243,graphml/Cogentco.graphml,2,,clustered,0.4;-0.3,29,28,19,10,0,19,0,19,19,0,0,edgeCount
474,197,243,graphml/Cogentco.graphml,1,,clustered,0.4;-0.3,8,12,8,0,2,8,0,8,12,0,2,edgeCount
473,197,243,graphml/Cogentco.graphml,2,,clustered,0.4;-0.3,9,12,5,4,0,5,0,5,5,0,0,edgeCount
472,197,243,graphml/Cogentco.graphml,1,,clustered,0.4;-0.3,10,10,10,0,0,10,0,10,10,0,0,edgeCount
471,197,243,graphml/Cogentco.graphml,2,,clustered,0.4;-0.3,10,8,7,3,2,8,1,8,8,1,2,edgeCount
470,197,243,graphml/Cogentco.graphml,2,,clustered,0.4;-0.3,12,12,12,0,0,12,0,12,12,0,0,edgeCount
469,197,243,graphml/Cogentco.graphml,2,,clustered,0.4;-0.3,6,6,6,0,0,6,0,6,6,0,0,edgeCount
468,197,243,graphml/Cogentco.graphml,3,,clustered,0.4;-0.3,11,11,8,3,2,11,3,11,11,3,2,edgeCount
467,197,243,graphml/Cogentco.graphml,2,,clustered,0.4;-0.3,14,13,7,7,0,7,0,7,7,0,0,edgeCount
466,197,243,graphml/Cogentco.graphml,2,,clustered,0.4;-0.3,8,5,5,3,0,5,0,5,5,0,0,edgeCount
465,197,243,graphml/Cogentco.graphml,2,,clustered,0.4;-0.3,33,52,17,16,2,65,48,65,70,48,2,edgeCount
464,197,243,graphml/Cogentco.graphml,1,,clustered,0.4;-0.3,23,23,23,0,2,23,0,23,23,0,2,edgeCount
463,197,243,graphml/Cogentco.graphml,2,,clustered,0.4;-0.3,32,11,10,22,4,-1,-11,26,23,16,4,edgeCount
462,197,243,graphml/Cogentco.graphml,2,,clustered,0.4;-0.3,13,13,13,0,0,13,0,13,13,0,0,edgeCount
461,197,243,graphml/Cogentco.graphml,2,,clustered,0.4;-0.3,8,8,8,0,0,8,0,8,8,0,0,edgeCount
460,197,243,graphml/Cogentco.graphml,1,,clustered,0.4;-0.3,23,24,23,0,2,23,0,23,24,0,2,edgeCount
459,197,243,graphml/Cogentco.graphml,2,,clustered,0.4;-0.3,14,14,12,2,0,14,2,14,14,2,0,edgeCount
458,197,243,graphml/Cogentco.graphml,1,,clustered,0.4;-0.3,10,15,10,0,2,10,0,10,15,0,2,edgeCount
457,197,243,graphml/Cogentco.graphml,2,,clustered,0.4;-0.3,10,10,9,1,0,10,1,10,10,1,0,edgeCount
456,197,243,graphml/Cogentco.graphml,2,,clustered,0.4;-0.3,12,12,12,0,0,12,0,12,12,0,0,edgeCount
455,197,243,graphml/Cogentco.graphml,2,,clustered,0.4;-0.3,4,4,4,0,0,4,0,4,4,0,0,edgeCount
454,197,243,graphml/Cogentco.graphml,1,,clustered,0.4;-0.3,12,12,12,0,0,12,0,12,12,0,0,edgeCount
453,197,243,graphml/Cogentco.graphml,1,,clustered,0.4;-0.3,17,17,17,0,0,17,0,17,17,0,0,edgeCount
452,197,243,graphml/Cogentco.graphml,2,,clustered,0.4;-0.3,22,22,16,6,0,22,6,22,22,6,0,edgeCount
451,197,243,graphml/Cogentco.graphml,2,,clustered,0.4;-0.3,36,8,8,28,2,8,0,8,8,0,2,edgeCount
450,197,243,graphml/Cogentco.graphml,3,,clustered,0.4;-0.3,17,5,5,12,0,5,0,5,5,0,0,edgeCount
449,197,243,graphml/Cogentco.graphml,1,,clustered,0.4;-0.3,20,20,20,0,2,20,0,20,20,0,2,edgeCount
448,197,243,graphml/Cogentco.graphml,2,,clustered,0.4;-0.3,15,14,13,2,0,14,1,14,14,1,0,edgeCount
447,197,243,graphml/Cogentco.graphml,2,,clustered,0.4;-0.3,7,7,7,0,0,7,0,7,7,0,0,edgeCount
446,197,243,graphml/Cogentco.graphml,1,,clustered,0.4;-0.3,6,14,6,0,2,6,0,6,14,0,2,edgeCount
445,197,243,graphml/Cogentco.graphml,2,,clustered,0.4;-0.3,7,7,7,0,0,7,0,7,7,0,0,edgeCount
444,197,243,graphml/Cogentco.graphml,2,,clustered,0.4;-0.3,21,20,12,9,2,53,41,53,53,41,2,edgeCount
443,197,243,graphml/Cogentco.graphml,2,,clustered,0.4;-0.3,7,7,7,0,0,7,0,7,7,0,0,edgeCount
442,197,243,graphml/Cogentco.graphml,1,,clustered,0.4;-0.3,12,23,12,0,2,12,0,12,23,0,2,edgeCount
441,197,243,graphml/Cogentco.graphml,2,,clustered,0.4;-0.3,9,9,9,0,0,9,0,9,9,0,0,edgeCount
440,197,243,graphml/Cogentco.graphml,2,,clustered,0.4;-0.3,14,14,11,3,0,14,3,14,14,3,0,edgeCount
439,197,243,graphml/Cogentco.graphml,2,,clustered,0.4;-0.3,17,10,10,7,0,10,0,10,10,0,0,edgeCount
438,197,243,graphml/Cogentco.graphml,2,,clustered,0.4;-0.3,9,9,6,3,0,9,3,9,9,3,0,edgeCount
437,197,243,graphml/Cogentco.graphml,2,,clustered,0.4;-0.3,27,20,20,7,2,20,0,20,20,0,2,edgeCount
436,197,243,graphml/Cogentco.graphml,1,,clustered,0.4;-0.3,17,9,9,8,4,-1,-10,17,9,8,4,edgeCount
435,197,243,graphml/Cogentco.graphml,1,,clustered,0.4;-0.3,10,10,10,0,2,10,0,10,10,0,2,edgeCount
434,197,243,graphml/Cogentco.graphml,2,,clustered,0.4;-0.3,5,3,3,2,0,3,0,3,3,0,0,edgeCount
433,197,243,graphml/Cogentco.graphml,2,,clustered,0.4;-0.3,6,6,6,0,0,7,1,7,7,1,0,edgeCount
432,197,243,graphml/Cogentco.graphml,2,,clustered,0.4;-0.3,18,18,16,2,0,18,2,18,18,2,0,edgeCount
431,197,243,graphml/Cogentco.graphml,2,,clustered,0.4;-0.3,13,13,12,1,0,13,1,13,13,1,0,edgeCount
430,197,243,graphml/Cogentco.graphml,2,,clustered,0.4;-0.3,17,17,17,0,0,17,0,17,17,0,0,edgeCount
429,197,243,graphml/Cogentco.graphml,1,,clustered,0.4;-0.3,16,16,16,0,0,16,0,16,16,0,0,edgeCount
428,197,243,graphml/Cogentco.graphml,1,,clustered,0.4;-0.3,8,8,8,0,2,8,0,8,8,0,2,edgeCount
427,197,243,graphml/Cogentco.graphml,2,,clustered,0.4;-0.3,8,19,6,2,2,16,10,16,16,10,2,edgeCount
426,197,243,graphml/Cogentco.graphml,1,,clustered,0.4;-0.3,13,13,13,0,0,13,0,13,13,0,0,edgeCount
425,197,243,graphml/Cogentco.graphml,1,,clustered,0.4;-0.3,24,31,24,0,2,24,0,24,31,0,2,edgeCount
424,197,243,graphml/Cogentco.graphml,2,,clustered,0.4;-0.3,21,21,21,0,0,21,0,21,21,0,0,edgeCount
423,197,243,graphml/Cogentco.graphml,2,,clustered,0.4;-0.3,13,13,11,2,0,13,2,13,13,2,0,edgeCount
422,197,243,graphml/Cogentco.graphml,1,,clustered,0.4;-0.3,7,7,7,0,0,7,0,7,7,0,0,edgeCount
421,197,243,graphml/Cogentco.graphml,2,,clustered,0.4;-0.3,22,6,6,16,2,6,0,22,6,16,2,edgeCount
420,197,243,graphml/Cogentco.graphml,2,,clustered,0.4;-0.3,23,22,18,5,0,22,4,22,22,4,0,edgeCount
419,197,243,graphml/Cogentco.graphml,1,,clustered,0.4;-0.3,6,6,6,0,0,6,0,6,6,0,0,edgeCount
418,197,243,graphml/Cogentco.graphml,3,,clustered,0.4;-0.3,10,10,9,1,0,10,1,10,10,1,0,edgeCount
417,197,243,graphml/Cogentco.graphml,2,,clustered,0.4;-0.3,20,20,15,5,0,20,5,20,20,5,0,edgeCount
416,197,243,graphml/Cogentco.graphml,2,,clustered,0.4;-0.3,19,19,19,0,0,19,0,19,19,0,0,edgeCount
415,197,243,graphml/Cogentco.graphml,1,,clustered,0.4;-0.3,4,4,4,0,4,4,0,4,4,0,4,edgeCount
414,197,243,graphml/Cogentco.graphml,2,,clustered,0.4;-0.3,5,5,5,0,0,5,0,5,5,0,0,edgeCount
413,197,243,graphml/Cogentco.graphml,2,,clustered,0.4;-0.3,14,14,14,0,0,14,0,14,14,0,0,edgeCount
412,197,243,graphml/Cogentco.graphml,2,,clustered,0.4;-0.3,4,7,4,0,2,4,0,4,4,0,2,edgeCount
411,197,243,graphml/Cogentco.graphml,2,,clustered,0.4;-0.3,17,17,13,4,0,17,4,17,17,4,0,edgeCount
410,197,243,graphml/Cogentco.graphml,2,,clustered,0.4;-0.3,5,5,5,0,2,5,0,5,5,0,2,edgeCount
409,197,243,graphml/Cogentco.graphml,2,,clustered,0.4;-0.3,12,12,9,3,0,12,3,12,12,3,0,edgeCount
408,197,243,graphml/Cogentco.graphml,2,,clustered,0.4;-0.3,13,13,13,0,0,13,0,13,13,0,0,edgeCount
407,197,243,graphml/Cogentco.graphml,2,,clustered,0.4;-0.3,10,6,6,4,0,6,0,6,6,0,0,edgeCount
406,197,243,graphml/Cogentco.graphml,2,,clustered,0.4;-0.3,15,15,15,0,0,15,0,15,15,0,0,edgeCount
405,197,243,graphml/Cogentco.graphml,2,,clustered,0.4;-0.3,14,8,8,6,0,8,0,8,8,0,0,edgeCount
404,197,243,graphml/Cogentco.graphml,2,,clustered,0.4;-0.3,15,15,15,0,2,15,0,15,15,0,2,edgeCount
403,197,243,graphml/Cogentco.graphml,2,,clustered,0.4;-0.3,16,16,14,2,0,16,2,16,16,2,0,edgeCount
402,197,243,graphml/Cogentco.graphml,2,,clustered,0.4;-0.3,11,11,11,0,0,11,0,11,11,0,0,edgeCount
401,197,243,graphml/Cogentco.graphml,2,,clustered,0.4;-0.3,15,14,11,4,6,15,4,15,14,4,6,edgeCount
400,197,243,graphml/Cogentco.graphml,3,,clustered,0.4;-0.3,8,8,8,0,0,8,0,8,8,0,0,edgeCount
399,197,243,graphml/Cogentco.graphml,2,,clustered,0.4;-0.3,18,18,12,6,2,50,38,50,50,38,2,edgeCount
398,197,243,graphml/Cogentco.graphml,2,,clustered,0.4;-0.3,8,8,7,1,2,8,1,8,8,1,2,edgeCount
397,197,243,graphml/Cogentco.graphml,1,,clustered,0.4;-0.3,19,25,19,0,2,19,0,19,25,0,2,edgeCount
396,197,243,graphml/Cogentco.graphml,2,,clustered,0.4;-0.3,20,42,11,9,14,42,31,42,42,31,14,edgeCount
395,197,243,graphml/Cogentco.graphml,1,,clustered,0.4;-0.3,9,9,9,0,2,9,0,9,9,0,2,edgeCount
394,197,243,graphml/Cogentco.graphml,1,,clustered,0.4;-0.3,9,10,9,0,4,9,0,9,10,0,4,edgeCount
393,197,243,graphml/Cogentco.graphml,2,,clustered,0.4;-0.3,10,9,9,1,0,10,1,10,9,1,0,edgeCount
392,197,243,graphml/Cogentco.graphml,2,,clustered,0.4;-0.3,31,31,14,17,0,31,17,31,31,17,0,edgeCount
391,197,243,graphml/Cogentco.graphml,2,,clustered,0.4;-0.3,40,20,12,28,2,12,0,12,12,0,2,edgeCount
390,197,243,graphml/Cogentco.graphml,2,,clustered,0.4;-0.3,14,29,9,5,0,12,3,12,12,3,0,edgeCount
389,197,243,graphml/Cogentco.graphml,1,,clustered,0.4;-0.3,2,2,2,0,0,2,0,2,2,0,0,edgeCount
388,197,243,graphml/Cogentco.graphml,2,,clustered,0.4;-0.3,13,13,11,2,14,-1,-12,13,13,2,14,edgeCount
387,197,243,graphml/Cogentco.graphml,2,,clustered,0.4;-0.3,21,21,18,3,0,21,3,21,21,3,0,edgeCount
386,197,243,graphml/Cogentco.graphml,1,,clustered,0.4;-0.3,13,13,13,0,2,13,0,13,13,0,2,edgeCount
385,197,243,graphml/Cogentco.graphml,1,,clustered,0.4;-0.3,7,7,7,0,0,7,0,7,7,0,0,edgeCount
384,197,243,graphml/Cogentco.graphml,1,,clustered,0.4;-0.3,14,14,14,0,0,14,0,14,14,0,0,edgeCount
383,197,243,graphml/Cogentco.graphml,1,,clustered,0.4;-0.3,8,8,8,0,4,8,0,8,8,0,4,edgeCount
382,197,243,graphml/Cogentco.graphml,1,,clustered,0.4;-0.3,22,22,22,0,0,22,0,22,22,0,0,edgeCount
381,197,243,graphml/Cogentco.graphml,1,,clustered,0.4;-0.3,6,6,6,0,4,6,0,6,6,0,4,edgeCount
380,197,243,graphml/Cogentco.graphml,2,,clustered,0.4;-0.3,27,5,5,22,2,5,0,5,5,0,2,edgeCount
379,197,243,graphml/Cogentco.graphml,1,,clustered,0.4;-0.3,17,17,17,0,0,17,0,17,17,0,0,edgeCount
378,197,243,graphml/Cogentco.graphml,2,,clustered,0.4;-0.3,19,19,16,3,2,19,3,19,19,3,2,edgeCount
377,197,243,graphml/Cogentco.graphml,2,,clustered,0.4;-0.3,20,20,20,0,0,20,0,20,20,0,0,edgeCount
376,197,243,graphml/Cogentco.graphml,2,,clustered,0.4;-0.3,24,24,21,3,0,24,3,24,24,3,0,edgeCount
375,197,243,graphml/Cogentco.graphml,3,,clustered,0.4;-0.3,17,15,14,3,0,43,29,43,43,29,0,edgeCount
374,197,243,graphml/Cogentco.graphml,2,,clustered,0.4;-0.3,16,19,14,2,0,15,1,15,15,1,0,edgeCount
373,197,243,graphml/Cogentco.graphml,2,,clustered,0.4;-0.3,44,26,14,30,2,14,0,14,14,0,2,edgeCount
372,197,243,graphml/Cogentco.graphml,2,,clustered,0.4;-0.3,38,38,10,28,2,38,28,38,43,28,2,edgeCount
371,197,243,graphml/Cogentco.graphml,2,,clustered,0.4;-0.3,8,8,8,0,0,8,0,8,8,0,0,edgeCount
370,197,243,graphml/Cogentco.graphml,3,,clustered,0.4;-0.3,21,21,7,14,0,21,14,21,21,14,0,edgeCount
369,197,243,graphml/Cogentco.graphml,1,,clustered,0.4;-0.3,13,13,13,0,0,13,0,13,13,0,0,edgeCount
368,197,243,graphml/Cogentco.graphml,1,,clustered,0.4;-0.3,9,9,9,0,0,9,0,9,9,0,0,edgeCount
367,197,243,graphml/Cogentco.graphml,1,,clustered,0.4;-0.3,41,41,17,24,4,-1,-18,41,41,24,4,edgeCount
366,197,243,graphml/Cogentco.graphml,2,,clustered,0.4;-0.3,6,6,4,2,0,6,2,6,6,2,0,edgeCount
365,197,243,graphml/Cogentco.graphml,2,,clustered,0.4;-0.3,5,5,5,0,0,5,0,5,5,0,0,edgeCount
364,197,243,graphml/Cogentco.graphml,2,,clustered,0.4;-0.3,16,16,9,7,0,14,5,14,14,5,0,edgeCount
363,197,243,graphml/Cogentco.graphml,2,,clustered,0.4;-0.3,9,9,6,3,0,9,3,9,9,3,0,edgeCount
362,197,243,graphml/Cogentco.graphml,2,,clustered,0.4;-0.3,11,13,3,8,2,3,0,3,3,0,2,edgeCount
361,197,243,graphml/Cogentco.graphml,2,,clustered,0.4;-0.3,16,16,15,1,0,16,1,16,16,1,0,edgeCount
360,197,243,graphml/Cogentco.graphml,1,,clustered,0.4;-0.3,7,9,7,0,2,7,0,7,9,0,2,edgeCount
359,197,243,graphml/Cogentco.graphml,1,,clustered,0.4;-0.3,9,32,9,0,2,9,0,9,32,0,2,edgeCount
358,197,243,graphml/Cogentco.graphml,2,,clustered,0.4;-0.3,14,14,8,6,0,14,6,14,14,6,0,edgeCount
357,197,243,graphml/Cogentco.graphml,2,,clustered,0.4;-0.3,15,15,14,1,2,15,1,15,15,1,2,edgeCount
356,197,243,graphml/Cogentco.graphml,1,,clustered,0.4;-0.3,3,21,3,0,2,3,0,3,21,0,2,edgeCount
355,197,243,graphml/Cogentco.graphml,2,,clustered,0.4;-0.3,26,37,10,16,2,26,16,26,37,16,2,edgeCount
354,197,243,graphml/Cogentco.graphml,2,,clustered,0.4;-0.3,21,21,15,6,0,21,6,21,21,6,0,edgeCount
353,197,243,graphml/Cogentco.graphml,2,,clustered,0.4;-0.3,8,8,6,2,0,8,2,8,8,2,0,edgeCount
352,197,243,graphml/Cogentco.graphml,2,,clustered,0.4;-0.3,7,7,7,0,0,7,0,7,7,0,0,edgeCount
351,197,243,graphml/Cogentco.graphml,2,,clustered,0.4;-0.3,15,16,9,6,2,29,20,29,30,20,2,edgeCount
350,197,243,graphml/Cogentco.graphml,1,,clustered,0.4;-0.3,8,8,8,0,2,8,0,8,8,0,2,edgeCount
349,197,243,graphml/Cogentco.graphml,2,,clustered,0.4;-0.3,12,12,12,0,0,38,26,38,38,26,0,edgeCount
348,197,243,graphml/Cogentco.graphml,1,,clustered,0.4;-0.3,31,33,15,16,4,-1,-16,31,33,16,4,edgeCount
347,197,243,graphml/Cogentco.graphml,3,,clustered,0.4;-0.3,7,7,2,5,0,7,5,7,7,5,0,edgeCount
346,197,243,graphml/Cogentco.graphml,1,,clustered,0.4;-0.3,15,15,15,0,2,15,0,15,15,0,2,edgeCount
345,197,243,graphml/Cogentco.graphml,2,,clustered,0.4;-0.3,9,18,8,1,0,17,9,17,17,9,0,edgeCount
344,197,243,graphml/Cogentco.graphml,2,,clustered,0.4;-0.3,24,46,18,6,2,20,2,24,46,6,2,edgeCount
343,197,243,graphml/Cogentco.graphml,1,,clustered,0.4;-0.3,13,13,13,0,0,13,0,13,13,0,0,edgeCount
342,197,243,graphml/Cogentco.graphml,3,,clustered,0.4;-0.3,24,8,5,19,2,8,3,8,8,3,2,edgeCount
341,197,243,graphml/Cogentco.graphml,1,,clustered,0.4;-0.3,5,5,5,0,4,5,0,5,5,0,4,edgeCount
340,197,243,graphml/Cogentco.graphml,2,,clustered,0.4;-0.3,58,58,15,43,2,58,43,58,58,43,2,edgeCount
339,197,243,graphml/Cogentco.graphml,2,,clustered,0.4;-0.3,6,6,6,0,0,6,0,6,6,0,0,edgeCount
338,197,243,graphml/Cogentco.graphml,1,,clustered,0.4;-0.3,10,10,10,0,2,10,0,10,10,0,2,edgeCount
337,197,243,graphml/Cogentco.graphml,1,,clustered,0.4;-0.3,8,8,8,0,0,8,0,8,8,0,0,edgeCount
336,197,243,graphml/Cogentco.graphml,2,,clustered,0.4;-0.3,18,18,18,0,0,18,0,18,18,0,0,edgeCount
335,197,243,graphml/Cogentco.graphml,1,,clustered,0.4;-0.3,2,2,2,0,0,2,0,2,2,0,0,edgeCount
334,197,243,graphml/Cogentco.graphml,1,,clustered,0.4;-0.3,6,6,6,0,2,6,0,6,6,0,2,edgeCount
333,197,243,graphml/Cogentco.graphml,2,,clustered,0.4;-0.3,20,20,19,1,0,20,1,20,20,1,0,edgeCount
332,197,243,graphml/Cogentco.graphml,2,,clustered,0.4;-0.3,11,17,6,5,0,7,1,7,7,1,0,edgeCount
331,197,243,graphml/Cogentco.graphml,1,,clustered,0.4;-0.3,17,17,17,0,4,17,0,17,17,0,4,edgeCount
330,197,243,graphml/Cogentco.graphml,2,,clustered,0.4;-0.3,7,7,7,0,0,7,0,7,7,0,0,edgeCount
329,197,243,graphml/Cogentco.graphml,3,,clustered,0.4;-0.3,32,32,12,20,0,32,20,32,32,20,0,edgeCount
328,197,243,graphml/Cogentco.graphml,2,,clustered,0.4;-0.3,2,2,2,0,0,2,0,2,2,0,0,edgeCount
327,197,243,graphml/Cogentco.graphml,1,,clustered,0.4;-0.3,11,11,11,0,0,11,0,11,11,0,0,edgeCount
326,197,243,graphml/Cogentco.graphml,1,,clustered,0.4;-0.3,12,14,12,0,2,12,0,12,14,0,2,edgeCount
325,197,243,graphml/Cogentco.graphml,2,,clustered,0.4;-0.3,9,9,8,1,0,9,1,9,9,1,0,edgeCount
324,197,243,graphml/Cogentco.graphml,2,,clustered,0.4;-0.3,9,8,8,1,2,8,0,9,8,1,2,edgeCount
323,197,243,graphml/Cogentco.graphml,2,,clustered,0.4;-0.3,14,14,14,0,0,14,0,14,14,0,0,edgeCount
322,197,243,graphml/Cogentco.graphml,1,,clustered,0.4;-0.3,10,10,10,0,0,10,0,10,10,0,0,edgeCount
321,197,243,graphml/Cogentco.graphml,2,,clustered,0.4;-0.3,19,26,9,10,2,19,10,19,26,10,2,edgeCount
320,197,243,graphml/Cogentco.graphml,1,,clustered,0.4;-0.3,7,7,7,0,0,7,0,7,7,0,0,edgeCount
319,197,243,graphml/Cogentco.graphml,2,,clustered,0.4;-0.3,18,6,6,12,2,6,0,6,6,0,2,edgeCount
318,197,243,graphml/Cogentco.graphml,2,,clustered,0.4;-0.3,7,7,7,0,0,7,0,7,7,0,0,edgeCount
317,197,243,graphml/Cogentco.graphml,2,,clustered,0.4;-0.3,6,6,6,0,0,9,3,9,6,3,0,edgeCount
316,197,243,graphml/Cogentco.graphml,2,,clustered,0.4;-0.3,12,18,12,0,2,12,0,12,18,0,2,edgeCount
315,197,243,graphml/Cogentco.graphml,2,,clustered,0.4;-0.3,28,18,10,18,4,10,0,28,18,18,4,edgeCount
314,197,243,graphml/Cogentco.graphml,2,,clustered,0.4;-0.3,35,7,7,28,2,7,0,35,7,28,2,edgeCount
313,197,243,graphml/Cogentco.graphml,2,,clustered,0.4;-0.3,7,7,7,0,0,7,0,7,7,0,0,edgeCount
312,197,243,graphml/Cogentco.graphml,3,,clustered,0.4;-0.3,9,6,4,5,0,4,0,4,4,0,0,edgeCount
311,197,243,graphml/Cogentco.graphml,2,,clustered,0.4;-0.3,7,7,7,0,2,7,0,7,7,0,2,edgeCount
310,197,243,graphml/Cogentco.graphml,1,,clustered,0.4;-0.3,10,22,10,0,2,10,0,10,22,0,2,edgeCount
309,197,243,graphml/Cogentco.graphml,2,,clustered,0.4;-0.3,59,59,17,42,0,59,42,59,59,42,0,edgeCount
308,197,243,graphml/Cogentco.graphml,2,,clustered,0.4;-0.3,13,17,9,4,0,9,0,9,9,0,0,edgeCount
307,197,243,graphml/Cogentco.graphml,1,,clustered,0.4;-0.3,11,11,11,0,0,11,0,11,11,0,0,edgeCount
306,197,243,graphml/Cogentco.graphml,3,,clustered,0.4;-0.3,30,8,8,22,0,8,0,8,8,0,0,edgeCount
305,197,243,graphml/Cogentco.graphml,2,,clustered,0.4;-0.3,9,7,7,2,4,7,0,7,7,0,4,edgeCount
304,197,243,graphml/Cogentco.graphml,2,,clustered,0.4;-0.3,9,9,9,0,0,9,0,9,9,0,0,edgeCount
303,197,243,graphml/Cogentco.graphml,2,,clustered,0.4;-0.3,15,15,14,1,0,15,1,15,15,1,0,edgeCount
302,197,243,graphml/Cogentco.graphml,1,,clustered,0.4;-0.3,7,7,7,0,0,7,0,7,7,0,0,edgeCount
301,197,243,graphml/Cogentco.graphml,2,,clustered,0.4;-0.3,12,12,9,3,0,12,3,12,12,3,0,edgeCount
300,197,243,graphml/Cogentco.graphml,2,,clustered,0.4;-0.3,24,41,16,8,2,17,1,17,17,1,2,edgeCount
299,197,243,graphml/Cogentco.graphml,2,,clustered,0.4;-0.3,2,2,2,0,0,2,0,2,2,0,0,edgeCount
298,197,243,graphml/Cogentco.graphml,2,,clustered,0.4;-0.3,2,2,2,0,0,2,0,2,2,0,0,edgeCount
297,197,243,graphml/Cogentco.graphml,1,,clustered,0.4;-0.3,9,12,9,0,4,9,0,9,12,0,4,edgeCount
296,197,243,graphml/Cogentco.graphml,1,,clustered,0.4;-0.3,11,11,11,0,4,11,0,11,11,0,4,edgeCount
295,197,243,graphml/Cogentco.graphml,3,,clustered,0.4;-0.3,21,20,4,17,0,4,0,4,4,0,0,edgeCount
294,197,243,graphml/Cogentco.graphml,2,,clustered,0.4;-0.3,8,5,5,3,4,5,0,5,5,0,4,edgeCount
293,197,243,graphml/Cogentco.graphml,2,,clustered,0.4;-0.3,41,48,16,25,2,41,25,41,48,25,2,edgeCount
292,197,243,graphml/Cogentco.graphml,2,,clustered,0.4;-0.3,24,13,13,11,0,13,0,13,13,0,0,edgeCount
291,197,243,graphml/Cogentco.graphml,2,,clustered,0.4;-0.3,5,5,5,0,0,5,0,5,5,0,0,edgeCount
290,197,243,graphml/Cogentco.graphml,2,,clustered,0.4;-0.3,10,11,7,3,2,22,15,22,22,15,2,edgeCount
289,197,243,graphml/Cogentco.graphml,1,,clustered,0.4;-0.3,6,6,6,0,0,6,0,6,6,0,0,edgeCount
288,197,243,graphml/Cogentco.graphml,1,,clustered,0.4;-0.3,14,14,14,0,2,14,0,14,14,0,2,edgeCount
287,197,243,graphml/Cogentco.graphml,1,,clustered,0.4;-0.3,21,21,21,0,0,21,0,21,21,0,0,edgeCount
286,197,243,graphml/Cogentco.graphml,2,,clustered,0.4;-0.3,11,13,7,4,0,7,0,7,7,0,0,edgeCount
285,197,243,graphml/Cogentco.graphml,2,,clustered,0.4;-0.3,20,20,20,0,0,20,0,20,20,0,0,edgeCount
284,197,243,graphml/Cogentco.graphml,2,,clustered,0.4;-0.3,33,40,12,21,2,33,21,33,40,21,2,edgeCount
283,197,243,graphml/Cogentco.graphml,1,,clustered,0.4;-0.3,25,25,25,0,0,25,0,25,25,0,0,edgeCount
282,197,243,graphml/Cogentco.graphml,1,,clustered,0.4;-0.3,7,19,7,0,4,7,0,7,19,0,4,edgeCount
281,197,243,graphml/Cogentco.graphml,1,,clustered,0.4;-0.3,10,10,10,0,0,10,0,10,10,0,0,edgeCount
280,197,243,graphml/Cogentco.graphml,1,,clustered,0.4;-0.3,17,20,17,0,2,17,0,17,20,0,2,edgeCount
279,197,243,graphml/Cogentco.graphml,2,,clustered,0.4;-0.3,11,10,9,2,2,25,16,25,25,16,2,edgeCount
278,197,243,graphml/Cogentco.graphml,2,,clustered,0.4;-0.3,12,12,12,0,0,12,0,12,12,0,0,edgeCount
277,197,243,graphml/Cogentco.graphml,2,,clustered,0.4;-0.3,26,26,9,17,0,26,17,26,26,17,0,edgeCount
276,197,243,graphml/Cogentco.graphml,2,,clustered,0.4;-0.3,4,3,3,1,2,3,0,3,3,0,2,edgeCount
275,197,243,graphml/Cogentco.graphml,1,,clustered,0.4;-0.3,11,11,11,0,2,11,0,11,11,0,2,edgeCount
274,197,243,graphml/Cogentco.graphml,3,,clustered,0.4;-0.3,14,14,12,2,2,14,2,14,14,2,2,edgeCount
273,197,243,graphml/Cogentco.graphml,1,,clustered,0.4;-0.3,20,20,20,0,0,20,0,20,20,0,0,edgeCount
272,197,243,graphml/Cogentco.graphml,2,,clustered,0.4;-0.3,49,18,14,35,2,15,1,49,18,35,2,edgeCount
271,197,243,graphml/Cogentco.graphml,2,,clustered,0.4;-0.3,10,10,10,0,0,10,0,10,10,0,0,edgeCount
270,197,243,graphml/Cogentco.graphml,2,,clustered,0.4;-0.3,4,4,4,0,0,4,0,4,4,0,0,edgeCount
269,197,243,graphml/Cogentco.graphml,1,,clustered,0.4;-0.3,12,16,12,0,12,12,0,12,16,0,12,edgeCount
268,197,243,graphml/Cogentco.graphml,2,,clustered,0.4;-0.3,34,8,8,26,2,8,0,8,8,0,2,edgeCount
267,197,243,graphml/Cogentco.graphml,2,,clustered,0.4;-0.3,13,13,13,0,0,15,2,13,13,0,0,edgeCount
266,197,243,graphml/Cogentco.graphml,1,,clustered,0.4;-0.3,16,16,16,0,0,16,0,16,16,0,0,edgeCount
265,197,243,graphml/Cogentco.graphml,2,,clustered,0.4;-0.3,14,14,9,5,0,14,5,14,14,5,0,edgeCount
264,197,243,graphml/Cogentco.graphml,1,,clustered,0.4;-0.3,22,22,22,0,0,22,0,22,22,0,0,edgeCount
263,197,243,graphml/Cogentco.graphml,2,,clustered,0.4;-0.3,13,13,12,1,0,13,1,13,13,1,0,edgeCount
262,197,243,graphml/Cogentco.graphml,1,,clustered,0.4;-0.3,16,16,16,0,2,16,0,16,16,0,2,edgeCount
261,197,243,graphml/Cogentco.graphml,2,,clustered,0.4;-0.3,12,15,9,3,0,9,0,9,9,0,0,edgeCount
260,197,243,graphml/Cogentco.graphml,2,,clustered,0.4;-0.3,52,52,17,35,2,52,35,52,52,35,2,edgeCount
259,197,243,graphml/Cogentco.graphml,2,,clustered,0.4;-0.3,11,8,8,3,2,8,0,8,8,0,2,edgeCount
258,197,243,graphml/Cogentco.graphml,2,,clustered,0.4;-0.3,11,11,11,0,0,11,0,11,11,0,0,edgeCount
257,197,243,graphml/Cogentco.graphml,1,,clustered,0.4;-0.3,20,20,20,0,0,20,0,20,20,0,0,edgeCount
256,197,243,graphml/Cogentco.graphml,2,,clustered,0.4;-0.3,5,5,5,0,0,5,0,5,5,0,0,edgeCount
255,197,243,graphml/Cogentco.graphml,2,,clustered,0.4;-0.3,10,15,9,1,0,9,0,9,9,0,0,edgeCount
254,197,243,graphml/Cogentco.graphml,2,,clustered,0.4;-0.3,15,15,9,6,0,15,6,15,15,6,0,edgeCount
253,197,243,graphml/Cogentco.graphml,2,,clustered,0.4;-0.3,17,17,12,5,0,17,5,17,17,5,0,edgeCount
252,197,243,graphml/Cogentco.graphml,1,,clustered,0.4;-0.3,13,13,13,0,2,13,0,13,13,0,2,edgeCount
251,197,243,graphml/Cogentco.graphml,1,,clustered,0.4;-0.3,8,8,8,0,0,8,0,8,8,0,0,edgeCount
250,197,243,graphml/Cogentco.graphml,2,,clustered,0.4;-0.3,7,7,7,0,0,7,0,7,7,0,0,edgeCount
249,197,243,graphml/Cogentco.graphml,2,,clustered,0.4;-0.3,16,8,7,9,0,16,9,16,8,9,0,edgeCount
248,197,243,graphml/Cogentco.graphml,1,,clustered,0.4;-0.3,6,6,6,0,0,6,0,6,6,0,0,edgeCount
247,197,243,graphml/Cogentco.graphml,1,,clustered,0.4;-0.3,17,17,17,0,0,17,0,17,17,0,0,edgeCount
246,197,243,graphml/Cogentco.graphml,2,,clustered,0.4;-0.3,10,10,8,2,0,10,2,10,10,2,0,edgeCount
245,197,243,graphml/Cogentco.graphml,1,,clustered,0.4;-0.3,6,6,6,0,0,6,0,6,6,0,0,edgeCount
244,197,243,graphml/Cogentco.graphml,2,,clustered,0.4;-0.3,22,22,19,3,0,22,3,22,22,3,0,edgeCount
243,197,243,graphml/Cogentco.graphml,2,,clustered,0.4;-0.3,20,20,20,0,6,20,0,20,20,0,6,edgeCount
242,197,243,graphml/Cogentco.graphml,2,,clustered,0.4;-0.3,9,12,4,5,0,4,0,4,4,0,0,edgeCount
241,197,243,graphml/Cogentco.graphml,1,,clustered,0.4;-0.3,5,5,5,0,0,5,0,5,5,0,0,edgeCount
240,197,243,graphml/Cogentco.graphml,2,,clustered,0.4;-0.3,44,10,10,34,2,10,0,10,10,0,2,edgeCount
239,197,243,graphml/Cogentco.graphml,2,,clustered,0.4;-0.3,24,24,21,3,0,24,3,24,24,3,0,edgeCount
238,197,243,graphml/Cogentco.graphml,2,,clustered,0.4;-0.3,17,17,16,1,2,17,1,17,17,1,2,edgeCount
237,197,243,graphml/Cogentco.graphml,2,,clustered,0.4;-0.3,15,15,15,0,0,15,0,15,15,0,0,edgeCount
236,197,243,graphml/Cogentco.graphml,1,,clustered,0.4;-0.3,20,14,14,6,4,-1,-15,20,14,6,4,edgeCount
235,197,243,graphml/Cogentco.graphml,2,,clustered,0.4;-0.3,6,5,5,1,2,5,0,5,5,0,2,edgeCount
234,197,243,graphml/Cogentco.graphml,2,,clustered,0.4;-0.3,17,17,15,2,0,17,2,17,17,2,0,edgeCount
233,197,243,graphml/Cogentco.graphml,2,,clustered,0.4;-0.3,17,40,12,5,2,14,2,17,40,5,2,edgeCount
232,197,243,graphml/Cogentco.graphml,3,,clustered,0.4;-0.3,3,3,3,0,0,3,0,3,3,0,0,edgeCount
231,197,243,graphml/Cogentco.graphml,1,,clustered,0.4;-0.3,6,6,6,0,0,6,0,6,6,0,0,edgeCount
230,197,243,graphml/Cogentco.graphml,2,,clustered,0.4;-0.3,25,10,7,18,2,7,0,7,7,0,2,edgeCount
229,197,243,graphml/Cogentco.graphml,1,,clustered,0.4;-0.3,19,37,19,0,4,19,0,19,37,0,4,edgeCount
228,197,243,graphml/Cogentco.graphml,2,,clustered,0.4;-0.3,29,11,5,24,10,-1,-6,7,7,2,10,edgeCount
227,197,243,graphml/Cogentco.graphml,2,,clustered,0.4;-0.3,18,18,12,6,2,39,27,39,39,27,2,edgeCount
226,197,243,graphml/Cogentco.graphml,2,,clustered,0.4;-0.3,7,53,3,4,0,3,0,3,3,0,0,edgeCount
225,197,243,graphml/Cogentco.graphml,2,,clustered,0.4;-0.3,11,22,5,6,2,11,6,11,22,6,2,edgeCount
224,197,243,graphml/Cogentco.graphml,2,,clustered,0.4;-0.3,21,21,14,7,0,21,7,21,21,7,0,edgeCount
223,197,243,graphml/Cogentco.graphml,2,,clustered,0.4;-0.3,5,5,3,2,0,3,0,3,3,0,0,edgeCount
222,197,243,graphml/Cogentco.graphml,2,,clustered,0.4;-0.3,19,25,18,1,2,49,31,49,49,31,2,edgeCount
221,197,243,graphml/Cogentco.graphml,2,,clustered,0.4;-0.3,12,12,9,3,0,12,3,12,12,3,0,edgeCount
220,197,243,graphml/Cogentco.graphml,3,,clustered,0.4;-0.3,12,12,11,1,0,12,1,12,12,1,0,edgeCount
219,197,243,graphml/Cogentco.graphml,2,,clustered,0.4;-0.3,8,8,8,0,0,8,0,8,8,0,0,edgeCount
218,197,243,graphml/Cogentco.graphml,2,,clustered,0.4;-0.3,19,20,13,6,0,14,1,14,14,1,0,edgeCount
217,197,243,graphml/Cogentco.graphml,1,,clustered,0.4;-0.3,17,17,17,0,0,17,0,17,17,0,0,edgeCount
216,197,243,graphml/Cogentco.graphml,1,,clustered,0.4;-0.3,14,14,14,0,0,14,0,14,14,0,0,edgeCount
215,197,243,graphml/Cogentco.graphml,2,,clustered,0.4;-0.3,11,5,3,8,2,3,0,3,3,0,2,edgeCount
214,197,243,graphml/Cogentco.graphml,2,,clustered,0.4;-0.3,7,7,5,2,2,7,2,7,7,2,2,edgeCount
213,197,243,graphml/Cogentco.graphml,1,,clustered,0.4;-0.3,14,14,14,0,0,14,0,14,14,0,0,edgeCount
212,197,243,graphml/Cogentco.graphml,1,,clustered,0.4;-0.3,4,4,4,0,0,4,0,4,4,0,0,edgeCount
211,197,243,graphml/Cogentco.graphml,2,,clustered,0.4;-0.3,33,11,10,23,2,11,1,11,11,1,2,edgeCount
210,197,243,graphml/Cogentco.graphml,1,,clustered,0.4;-0.3,22,22,22,0,0,22,0,22,22,0,0,edgeCount
209,197,243,graphml/Cogentco.graphml,2,,clustered,0.4;-0.3,7,6,6,1,2,6,0,6,6,0,2,edgeCount
208,197,243,graphml/Cogentco.graphml,3,,clustered,0.4;-0.3,22,6,6,16,2,6,0,6,6,0,2,edgeCount
207,197,243,graphml/Cogentco.graphml,1,,clustered,0.4;-0.3,5,5,5,0,0,5,0,5,5,0,0,edgeCount
206,197,243,graphml/Cogentco.graphml,1,,clustered,0.4;-0.3,7,13,7,0,2,7,0,7,13,0,2,edgeCount
205,197,243,graphml/Cogentco.graphml,2,,clustered,0.4;-0.3,30,43,17,13,2,60,43,60,60,43,2,edgeCount
204,197,243,graphml/Cogentco.graphml,2,,clustered,0.4;-0.3,4,4,4,0,0,4,0,4,4,0,0,edgeCount
203,197,243,graphml/Cogentco.graphml,2,,clustered,0.4;-0.3,5,5,5,0,0,5,0,5,5,0,0,edgeCount
202,197,243,graphml/Cogentco.graphml,1,,clustered,0.4;-0.3,11,11,11,0,0,11,0,11,11,0,0,edgeCount
201,197,243,graphml/Cogentco.graphml,2,,clustered,0.4;-0.3,38,12,10,28,2,12,2,12,12,2,2,edgeCount
200,197,243,graphml/Cogentco.graphml,2,,clustered,0.4;-0.3,16,11,11,5,0,11,0,11,11,0,0,edgeCount
199,197,243,graphml/Cogentco.graphml,2,,clustered,0.4;-0.3,10,10,10,0,0,10,0,10,10,0,0,edgeCount
198,197,243,graphml/Cogentco.graphml,2,,clustered,0.4;-0.3,16,15,6,10,0,6,0,6,6,0,0,edgeCount
197,197,243,graphml/Cogentco.graphml,2,,clustered,0.4;-0.3,12,12,11,1,0,12,1,12,12,1,0,edgeCount
196,197,243,graphml/Cogentco.graphml,2,,clustered,0.4;-0.3,71,71,22,49,0,71,49,71,71,49,0,edgeCount
195,197,243,graphml/Cogentco.graphml,2,,clustered,0.4;-0.3,10,8,7,3,2,8,1,8,8,1,2,edgeCount
194,197,243,graphml/Cogentco.graphml,2,,clustered,0.4;-0.3,6,6,6,0,0,6,0,6,6,0,0,edgeCount
193,197,243,graphml/Cogentco.graphml,2,,clustered,0.4;-0.3,6,6,5,1,0,6,1,6,6,1,0,edgeCount
192,197,243,graphml/Cogentco.graphml,1,,clustered,0.4;-0.3,5,5,5,0,0,5,0,5,5,0,0,edgeCount
191,197,243,graphml/Cogentco.graphml,2,,clustered,0.4;-0.3,55,55,12,43,2,43,31,43,43,31,2,edgeCount
190,197,243,graphml/Cogentco.graphml,2,,clustered,0.4;-0.3,25,54,17,8,4,51,34,51,51,34,4,edgeCount
189,197,243,graphml/Cogentco.graphml,2,,clustered,0.4;-0.3,17,17,16,1,2,17,1,17,27,1,2,edgeCount
188,197,243,graphml/Cogentco.graphml,1,,clustered,0.4;-0.3,24,24,24,0,2,24,0,24,24,0,2,edgeCount
187,197,243,graphml/Cogentco.graphml,2,,clustered,0.4;-0.3,7,7,2,5,0,2,0,2,2,0,0,edgeCount
186,197,243,graphml/Cogentco.graphml,2,,clustered,0.4;-0.3,10,10,9,1,0,10,1,10,10,1,0,edgeCount
185,197,243,graphml/Cogentco.graphml,1,,clustered,0.4;-0.3,17,17,17,0,0,17,0,17,17,0,0,edgeCount
184,197,243,graphml/Cogentco.graphml,2,,clustered,0.4;-0.3,5,5,4,1,0,5,1,5,5,1,0,edgeCount
183,197,243,graphml/Cogentco.graphml,2,,clustered,0.4;-0.3,14,14,14,0,0,17,3,14,14,0,0,edgeCount
182,197,243,graphml/Cogentco.graphml,1,,clustered,0.4;-0.3,7,14,7,0,4,7,0,7,14,0,4,edgeCount
181,197,243,graphml/Cogentco.graphml,3,,clustered,0.4;-0.3,14,18,11,3,0,36,25,36,36,25,0,edgeCount
180,197,243,graphml/Cogentco.graphml,2,,clustered,0.4;-0.3,9,9,9,0,0,9,0,9,9,0,0,edgeCount
179,197,243,graphml/Cogentco.graphml,2,,clustered,0.4;-0.3,20,20,19,1,2,22,3,20,20,1,2,edgeCount
178,197,243,graphml/Cogentco.graphml,2,,clustered,0.4;-0.3,9,9,9,0,0,9,0,9,9,0,0,edgeCount
177,197,243,graphml/Cogentco.graphml,2,,clustered,0.4;-0.3,16,14,12,4,0,13,1,13,13,1,0,edgeCount
176,197,243,graphml/Cogentco.graphml,2,,clustered,0.4;-0.3,3,3,3,0,0,20,17,3,3,0,0,edgeCount
175,197,243,graphml/Cogentco.graphml,1,,clustered,0.4;-0.3,9,9,9,0,0,9,0,9,9,0,0,edgeCount
174,197,243,graphml/Cogentco.graphml,1,,clustered,0.4;-0.3,7,7,7,0,0,7,0,7,7,0,0,edgeCount
173,197,243,graphml/Cogentco.graphml,1,,clustered,0.4;-0.3,8,8,8,0,0,8,0,8,8,0,0,edgeCount
172,197,243,graphml/Cogentco.graphml,2,,clustered,0.4;-0.3,33,47,9,24,4,9,0,9,9,0,4,edgeCount
171,197,243,graphml/Cogentco.graphml,1,,clustered,0.4;-0.3,11,11,11,0,0,11,0,11,11,0,0,edgeCount
170,197,243,graphml/Cogentco.graphml,2,,clustered,0.4;-0.3,13,13,13,0,0,13,0,13,13,0,0,edgeCount
169,197,243,graphml/Cogentco.graphml,2,,clustered,0.4;-0.3,10,10,8,2,0,10,2,10,10,2,0,edgeCount
168,197,243,graphml/Cogentco.graphml,2,,clustered,0.4;-0.3,22,19,17,5,0,19,2,19,19,2,0,edgeCount
167,197,243,graphml/Cogentco.graphml,2,,clustered,0.4;-0.3,15,15,11,4,0,15,4,15,15,4,0,edgeCount
166,197,243,graphml/Cogentco.graphml,1,,clustered,0.4;-0.3,16,16,16,0,2,16,0,16,16,0,2,edgeCount
165,197,243,graphml/Cogentco.graphml,1,,clustered,0.4;-0.3,16,16,16,0,0,16,0,16,16,0,0,edgeCount
164,197,243,graphml/Cogentco.graphml,2,,clustered,0.4;-0.3,22,22,16,6,0,22,6,22,22,6,0,edgeCount
163,197,243,graphml/Cogentco.graphml,1,,clustered,0.4;-0.3,14,14,14,0,0,14,0,14,14,0,0,edgeCount
162,197,243,graphml/Cogentco.graphml,2,,clustered,0.4;-0.3,23,23,23,0,0,23,0,23,23,0,0,edgeCount
161,197,243,graphml/Cogentco.graphml,2,,clustered,0.4;-0.3,16,19,14,2,0,15,1,15,15,1,0,edgeCount
160,197,243,graphml/Cogentco.graphml,1,,clustered,0.4;-0.3,12,12,12,0,2,12,0,12,12,0,2,edgeCount
159,197,243,graphml/Cogentco.graphml,2,,clustered,0.4;-0.3,6,6,5,1,0,6,1,6,6,1,0,edgeCount
158,197,243,graphml/Cogentco.graphml,2,,clustered,0.4;-0.3,16,21,10,6,0,14,4,14,14,4,0,edgeCount
157,197,243,graphml/Cogentco.graphml,2,,clustered,0.4;-0.3,3,3,3,0,0,3,0,3,3,0,0,edgeCount
156,197,243,graphml/Cogentco.graphml,1,,clustered,0.4;-0.3,16,16,16,0,0,16,0,16,16,0,0,edgeCount
155,197,243,graphml/Cogentco.graphml,1,,clustered,0.4;-0.3,6,9,6,0,2,6,0,6,9,0,2,edgeCount
154,197,243,graphml/Cogentco.graphml,3,,clustered,0.4;-0.3,32,30,9,23,2,54,45,54,54,45,2,edgeCount
153,197,243,graphml/Cogentco.graphml,1,,clustered,0.4;-0.3,11,22,11,0,2,11,0,11,22,0,2,edgeCount
152,197,243,graphml/Cogentco.graphml,2,,clustered,0.4;-0.3,10,8,7,3,2,8,1,8,8,1,2,edgeCount
151,197,243,graphml/Cogentco.graphml,2,,clustered,0.4;-0.3,23,23,22,1,0,23,1,23,23,1,0,edgeCount
150,197,243,graphml/Cogentco.graphml,1,,clustered,0.4;-0.3,6,9,6,0,4,6,0,6,9,0,4,edgeCount
149,197,243,graphml/Cogentco.graphml,2,,clustered,0.4;-0.3,10,10,10,0,0,10,0,10,10,0,0,edgeCount
148,197,243,graphml/Cogentco.graphml,2,,clustered,0.4;-0.3,9,9,8,1,0,9,1,9,9,1,0,edgeCount
147,197,243,graphml/Cogentco.graphml,1,,clustered,0.4;-0.3,8,8,8,0,0,8,0,8,8,0,0,edgeCount
146,197,243,graphml/Cogentco.graphml,2,,clustered,0.4;-0.3,7,7,6,1,0,7,1,7,7,1,0,edgeCount
145,197,243,graphml/Cogentco.graphml,2,,clustered,0.4;-0.3,13,13,10,3,0,13,3,13,13,3,0,edgeCount
144,197,243,graphml/Cogentco.graphml,2,,clustered,0.4;-0.3,7,5,3,4,4,3,0,3,3,0,4,edgeCount
143,197,243,graphml/Cogentco.graphml,2,,clustered,0.4;-0.3,24,25,16,8,0,16,0,16,16,0,0,edgeCount
142,197,243,graphml/Cogentco.graphml,2,,clustered,0.4;-0.3,5,5,5,0,2,5,0,5,5,0,2,edgeCount
141,197,243,graphml/Cogentco.graphml,2,,clustered,0.4;-0.3,10,10,10,0,2,10,0,10,10,0,2,edgeCount
140,197,243,graphml/Cogentco.graphml,1,,clustered,0.4;-0.3,15,49,15,0,4,15,0,15,49,0,4,edgeCount
139,197,243,graphml/Cogentco.graphml,1,,clustered,0.4;-0.3,5,5,5,0,0,5,0,5,5,0,0,edgeCount
138,197,243,graphml/Cogentco.graphml,2,,clustered,0.4;-0.3,12,12,12,0,2,12,0,12,12,0,2,edgeCount
137,197,243,graphml/Cogentco.graphml,2,,clustered,0.4;-0.3,10,4,4,6,2,4,0,4,4,0,2,edgeCount
136,197,243,graphml/Cogentco.graphml,2,,clustered,0.4;-0.3,17,17,17,0,0,17,0,17,17,0,0,edgeCount
135,197,243,graphml/Cogentco.graphml,2,,clustered,0.4;-0.3,10,10,10,0,0,10,0,10,10,0,0,edgeCount
134,197,243,graphml/Cogentco.graphml,1,,clustered,0.4;-0.3,7,7,7,0,0,7,0,7,7,0,0,edgeCount
133,197,243,graphml/Cogentco.graphml,1,,clustered,0.4;-0.3,20,20,9,11,2,-1,-10,20,20,11,2,edgeCount
132,197,243,graphml/Cogentco.graphml,1,,clustered,0.4;-0.3,17,17,17,0,4,17,0,17,17,0,4,edgeCount
131,197,243,graphml/Cogentco.graphml,1,,clustered,0.4;-0.3,4,4,4,0,0,4,0,4,4,0,0,edgeCount
130,197,243,graphml/Cogentco.graphml,2,,clustered,0.4;-0.3,13,13,9,4,2,27,18,27,27,18,2,edgeCount
129,197,243,graphml/Cogentco.graphml,2,,clustered,0.4;-0.3,11,20,7,4,2,27,20,11,20,4,2,edgeCount
128,197,243,graphml/Cogentco.graphml,2,,clustered,0.4;-0.3,24,24,18,6,0,24,6,24,24,6,0,edgeCount
127,197,243,graphml/Cogentco.graphml,2,,clustered,0.4;-0.3,68,26,16,52,2,22,6,68,26,52,2,edgeCount
126,197,243,graphml/Cogentco.graphml,2,,clustered,0.4;-0.3,9,9,4,5,0,9,5,9,9,5,0,edgeCount
125,197,243,graphml/Cogentco.graphml,2,,clustered,0.4;-0.3,14,14,14,0,0,14,0,14,14,0,0,edgeCount
124,197,243,graphml/Cogentco.graphml,1,,clustered,0.4;-0.3,11,11,11,0,0,11,0,11,11,0,0,edgeCount
123,197,243,graphml/Cogentco.graphml,2,,clustered,0.4;-0.3,9,5,5,4,0,5,0,5,5,0,0,edgeCount
122,197,243,graphml/Cogentco.graphml,2,,clustered,0.4;-0.3,52,52,16,36,6,46,30,52,52,36,6,edgeCount
121,197,243,graphml/Cogentco.graphml,3,,clustered,0.4;-0.3,13,8,8,5,0,31,23,31,31,23,0,edgeCount
120,197,243,graphml/Cogentco.graphml,2,,clustered,0.4;-0.3,9,4,4,5,2,4,0,4,4,0,2,edgeCount
119,197,243,graphml/Cogentco.graphml,2,,clustered,0.4;-0.3,46,51,14,32,2,46,32,46,51,32,2,edgeCount
118,197,243,graphml/Cogentco.graphml,2,,clustered,0.4;-0.3,17,17,14,3,0,17,3,17,17,3,0,edgeCount
117,197,243,graphml/Cogentco.graphml,2,,clustered,0.4;-0.3,17,17,17,0,0,17,0,17,17,0,0,edgeCount
116,197,243,graphml/Cogentco.graphml,1,,clustered,0.4;-0.3,19,19,19,0,0,19,0,19,19,0,0,edgeCount
115,197,243,graphml/Cogentco.graphml,2,,clustered,0.4;-0.3,6,5,5,1,2,5,0,5,5,0,2,edgeCount
114,197,243,graphml/Cogentco.graphml,1,,clustered,0.4;-0.3,24,24,10,14,4,-1,-11,24,24,14,4,edgeCount
113,197,243,graphml/Cogentco.graphml,2,,clustered,0.4;-0.3,16,16,16,0,0,16,0,16,16,0,0,edgeCount
112,197,243,graphml/Cogentco.graphml,2,,clustered,0.4;-0.3,14,9,9,5,2,9,0,9,9,0,2,edgeCount
111,197,243,graphml/Cogentco.graphml,1,,clustered,0.4;-0.3,14,14,14,0,0,14,0,14,14,0,0,edgeCount
110,197,243,graphml/Cogentco.graphml,2,,clustered,0.4;-0.3,9,9,5,4,0,5,0,5,5,0,0,edgeCount
109,197,243,graphml/Cogentco.graphml,2,,clustered,0.4;-0.3,4,4,4,0,0,4,0,4,4,0,0,edgeCount
108,197,243,graphml/Cogentco.graphml,2,,clustered,0.4;-0.3,8,8,8,0,0,8,0,8,8,0,0,edgeCount
107,197,243,graphml/Cogentco.graphml,1,,clustered,0.4;-0.3,17,17,17,0,0,17,0,17,17,0,0,edgeCount
106,197,243,graphml/Cogentco.graphml,1,,clustered,0.4;-0.3,17,17,17,0,0,17,0,17,17,0,0,edgeCount
105,197,243,graphml/Cogentco.graphml,1,,clustered,0.4;-0.3,15,15,15,0,0,15,0,15,15,0,0,edgeCount
104,197,243,graphml/Cogentco.graphml,2,,clustered,0.4;-0.3,3,3,3,0,2,3,0,3,3,0,2,edgeCount
103,197,243,graphml/Cogentco.graphml,2,,clustered,0.4;-0.3,13,16,11,2,4,11,0,11,11,0,4,edgeCount
102,197,243,graphml/Cogentco.graphml,1,,clustered,0.4;-0.3,14,19,14,0,2,14,0,14,19,0,2,edgeCount
101,197,243,graphml/Cogentco.graphml,1,,clustered,0.4;-0.3,10,10,10,0,0,10,0,10,10,0,0,edgeCount
100,197,243,graphml/Cogentco.graphml,2,,clustered,0.4;-0.3,16,27,13,3,2,44,31,44,47,31,2,edgeCount
99,197,243,graphml/Cogentco.graphml,2,,clustered,0.4;-0.3,55,55,15,40,0,19,4,55,55,40,0,edgeCount
98,197,243,graphml/Cogentco.graphml,2,,clustered,0.4;-0.3,36,14,10,26,0,10,0,10,10,0,0,edgeCount
97,197,243,graphml/Cogentco.graphml,1,,clustered,0.4;-0.3,11,11,11,0,2,11,0,11,11,0,2,edgeCount
96,197,243,graphml/Cogentco.graphml,2,,clustered,0.4;-0.3,23,17,16,7,0,17,1,17,17,1,0,edgeCount
95,197,243,graphml/Cogentco.graphml,1,,clustered,0.4;-0.3,10,10,10,0,0,10,0,10,10,0,0,edgeCount
94,197,243,graphml/Cogentco.graphml,2,,clustered,0.4;-0.3,14,8,8,6,0,8,0,8,8,0,0,edgeCount
93,197,243,graphml/Cogentco.graphml,2,,clustered,0.4;-0.3,21,21,20,1,2,21,1,21,21,1,2,edgeCount
92,197,243,graphml/Cogentco.graphml,2,,clustered,0.4;-0.3,2,2,2,0,0,2,0,2,2,0,0,edgeCount
91,197,243,graphml/Cogentco.graphml,2,,clustered,0.4;-0.3,6,6,6,0,0,6,0,6,6,0,0,edgeCount
90,197,243,graphml/Cogentco.graphml,1,,clustered,0.4;-0.3,8,8,8,0,0,8,0,8,8,0,0,edgeCount
89,197,243,graphml/Cogentco.graphml,2,,clustered,0.4;-0.3,8,5,5,3,0,5,0,5,5,0,0,edgeCount
88,197,243,graphml/Cogentco.graphml,1,,clustered,0.4;-0.3,13,13,13,0,0,13,0,13,13,0,0,edgeCount
87,197,243,graphml/Cogentco.graphml,3,,clustered,0.4;-0.3,6,6,6,0,2,6,0,6,6,0,2,edgeCount
86,197,243,graphml/Cogentco.graphml,2,,clustered,0.4;-0.3,11,7,7,4,0,7,0,7,7,0,0,edgeCount
85,197,243,graphml/Cogentco.graphml,2,,clustered,0.4;-0.3,18,18,18,0,0,18,0,18,18,0,0,edgeCount
84,197,243,graphml/Cogentco.graphml,2,,clustered,0.4;-0.3,60,20,15,45,0,20,5,20,20,5,0,edgeCount
83,197,243,graphml/Cogentco.graphml,2,,clustered,0.4;-0.3,48,14,14,34,0,53,39,48,14,34,0,edgeCount
82,197,243,graphml/Cogentco.graphml,2,,clustered,0.4;-0.3,25,23,8,17,6,-1,-9,25,23,17,6,edgeCount
81,197,243,graphml/Cogentco.graphml,1,,clustered,0.4;-0.3,10,17,10,0,4,10,0,10,17,0,4,edgeCount
80,197,243,graphml/Cogentco.graphml,1,,clustered,0.4;-0.3,13,13,13,0,0,13,0,13,13,0,0,edgeCount
79,197,243,graphml/Cogentco.graphml,2,,clustered,0.4;-0.3,12,12,12,0,0,12,0,12,12,0,0,edgeCount
78,197,243,graphml/Cogentco.graphml,2,,clustered,0.4;-0.3,29,34,11,18,2,29,18,29,34,18,2,edgeCount
77,197,243,graphml/Cogentco.graphml,2,,clustered,0.4;-0.3,5,5,3,2,2,5,2,5,5,2,2,edgeCount
76,197,243,graphml/Cogentco.graphml,2,,clustered,0.4;-0.3,51,51,18,33,0,51,33,51,51,33,0,edgeCount
75,197,243,graphml/Cogentco.graphml,2,,clustered,0.4;-0.3,8,8,8,0,0,8,0,8,8,0,0,edgeCount
74,197,243,graphml/Cogentco.graphml,1,,clustered,0.4;-0.3,16,16,16,0,0,16,0,16,16,0,0,edgeCount
73,197,243,graphml/Cogentco.graphml,1,,clustered,0.4;-0.3,22,22,22,0,0,22,0,22,22,0,0,edgeCount
72,197,243,graphml/Cogentco.graphml,2,,clustered,0.4;-0.3,11,11,11,0,0,11,0,11,11,0,0,edgeCount
71,197,243,graphml/Cogentco.graphml,2,,clustered,0.4;-0.3,11,16,6,5,2,21,15,21,23,15,2,edgeCount
70,197,243,graphml/Cogentco.graphml,2,,clustered,0.4;-0.3,11,11,11,0,0,11,0,11,11,0,0,edgeCount
69,197,243,graphml/Cogentco.graphml,1,,clustered,0.4;-0.3,27,17,17,10,4,17,0,27,17,10,4,edgeCount
68,197,243,graphml/Cogentco.graphml,1,,clustered,0.4;-0.3,5,5,5,0,0,5,0,5,5,0,0,edgeCount
67,197,243,graphml/Cogentco.graphml,2,,clustered,0.4;-0.3,16,16,8,8,0,-1,-9,-1,-1,-9,0,edgeCount
66,197,243,graphml/Cogentco.graphml,2,,clustered,0.4;-0.3,73,19,19,54,2,19,0,19,19,0,2,edgeCount
65,197,243,graphml/Cogentco.graphml,2,,clustered,0.4;-0.3,12,11,5,7,0,5,0,5,5,0,0,edgeCount
64,197,243,graphml/Cogentco.graphml,2,,clustered,0.4;-0.3,14,17,14,0,0,17,3,17,17,3,0,edgeCount
63,197,243,graphml/Cogentco.graphml,1,,clustered,0.4;-0.3,10,10,10,0,0,10,0,10,10,0,0,edgeCount
62,197,243,graphml/Cogentco.graphml,1,,clustered,0.4;-0.3,3,3,3,0,0,3,0,3,3,0,0,edgeCount
61,197,243,graphml/Cogentco.graphml,2,,clustered,0.4;-0.3,8,7,7,1,0,7,0,7,7,0,0,edgeCount
60,197,243,graphml/Cogentco.graphml,1,,clustered,0.4;-0.3,12,12,12,0,0,12,0,12,12,0,0,edgeCount
59,197,243,graphml/Cogentco.graphml,2,,clustered,0.4;-0.3,13,13,13,0,0,18,5,13,13,0,0,edgeCount
58,197,243,graphml/Cogentco.graphml,2,,clustered,0.4;-0.3,16,16,10,6,0,16,6,16,16,6,0,edgeCount
57,197,243,graphml/Cogentco.graphml,1,,clustered,0.4;-0.3,16,16,16,0,0,16,0,16,16,0,0,edgeCount
56,197,243,graphml/Cogentco.graphml,1,,clustered,0.4;-0.3,21,21,10,11,4,-1,-11,21,21,11,4,edgeCount
55,197,243,graphml/Cogentco.graphml,1,,clustered,0.4;-0.3,12,12,12,0,2,12,0,12,12,0,2,edgeCount
54,197,243,graphml/Cogentco.graphml,2,,clustered,0.4;-0.3,20,20,14,6,0,20,6,20,20,6,0,edgeCount
53,197,243,graphml/Cogentco.graphml,2,,clustered,0.4;-0.3,57,21,15,42,2,16,1,16,16,1,2,edgeCount
52,197,243,graphml/Cogentco.graphml,2,,clustered,0.4;-0.3,12,12,8,4,0,12,4,12,12,4,0,edgeCount
51,197,243,graphml/Cogentco.graphml,3,,clustered,0.4;-0.3,9,12,7,2,2,13,6,13,13,6,2,edgeCount
50,197,243,graphml/Cogentco.graphml,1,,clustered,0.4;-0.3,21,21,21,0,0,21,0,21,21,0,0,edgeCount
49,197,243,graphml/Cogentco.graphml,2,,clustered,0.4;-0.3,12,12,12,0,0,14,2,12,12,0,0,edgeCount
48,197,243,graphml/Cogentco.graphml,1,,clustered,0.4;-0.3,24,24,24,0,0,24,0,24,24,0,0,edgeCount
47,197,243,graphml/Cogentco.graphml,2,,clustered,0.4;-0.3,9,16,6,3,2,25,19,9,16,3,2,edgeCount
46,197,243,graphml/Cogentco.graphml,1,,clustered,0.4;-0.3,5,5,5,0,0,5,0,5,5,0,0,edgeCount
45,197,243,graphml/Cogentco.graphml,3,,clustered,0.4;-0.3,37,37,10,27,0,37,27,37,37,27,0,edgeCount
44,197,243,graphml/Cogentco.graphml,1,,clustered,0.4;-0.3,23,23,23,0,2,23,0,23,23,0,2,edgeCount
43,197,243,graphml/Cogentco.graphml,1,,clustered,0.4;-0.3,2,2,2,0,0,2,0,2,2,0,0,edgeCount
42,197,243,graphml/Cogentco.graphml,1,,clustered,0.4;-0.3,57,60,25,32,4,-1,-26,57,60,32,4,edgeCount
41,197,243,graphml/Cogentco.graphml,2,,clustered,0.4;-0.3,13,17,9,4,0,9,0,9,9,0,0,edgeCount
40,197,243,graphml/Cogentco.graphml,2,,clustered,0.4;-0.3,18,24,9,9,4,9,0,9,9,0,4,edgeCount
39,197,243,graphml/Cogentco.graphml,1,,clustered,0.4;-0.3,10,24,10,0,2,10,0,10,24,0,2,edgeCount
38,197,243,graphml/Cogentco.graphml,1,,clustered,0.4;-0.3,30,16,12,18,4,-1,-13,30,16,18,4,edgeCount
37,197,243,graphml/Cogentco.graphml,2,,clustered,0.4;-0.3,61,61,16,45,6,57,41,61,61,45,6,edgeCount
36,197,243,graphml/Cogentco.graphml,2,,clustered,0.4;-0.3,22,11,11,11,0,11,0,11,11,0,0,edgeCount
35,197,243,graphml/Cogentco.graphml,1,,clustered,0.4;-0.3,9,9,9,0,0,9,0,9,9,0,0,edgeCount
34,197,243,graphml/Cogentco.graphml,2,,clustered,0.4;-0.3,12,12,12,0,0,12,0,12,12,0,0,edgeCount
33,197,243,graphml/Cogentco.graphml,3,,clustered,0.4;-0.3,31,31,8,23,0,31,23,31,31,23,0,edgeCount
32,197,243,graphml/Cogentco.graphml,2,,clustered,0.4;-0.3,24,24,23,1,0,24,1,24,24,1,0,edgeCount
31,197,243,graphml/Cogentco.graphml,2,,clustered,0.4;-0.3,14,8,8,6,4,10,2,8,8,0,4,edgeCount
30,197,243,graphml/Cogentco.graphml,2,,clustered,0.4;-0.3,11,11,11,0,0,11,0,11,11,0,0,edgeCount
29,197,243,graphml/Cogentco.graphml,3,,clustered,0.4;-0.3,36,36,8,28,0,36,28,36,36,28,0,edgeCount
28,197,243,graphml/Cogentco.graphml,2,,clustered,0.4;-0.3,9,9,9,0,0,9,0,9,9,0,0,edgeCount
27,197,243,graphml/Cogentco.graphml,2,,clustered,0.4;-0.3,9,9,8,1,0,9,1,9,9,1,0,edgeCount
26,197,243,graphml/Cogentco.graphml,1,,clustered,0.4;-0.3,8,8,8,0,0,8,0,8,8,0,0,edgeCount
25,197,243,graphml/Cogentco.graphml,2,,clustered,0.4;-0.3,16,16,14,2,0,16,2,16,16,2,0,edgeCount
24,197,243,graphml/Cogentco.graphml,2,,clustered,0.4;-0.3,17,24,7,10,2,17,10,17,24,10,2,edgeCount
23,197,243,graphml/Cogentco.graphml,1,,clustered,0.4;-0.3,6,6,6,0,2,6,0,6,6,0,2,edgeCount
22,197,243,graphml/Cogentco.graphml,2,,clustered,0.4;-0.3,17,27,12,5,2,35,23,35,35,23,2,edgeCount
21,197,243,graphml/Cogentco.graphml,3,,clustered,0.4;-0.3,4,26,4,0,0,10,6,10,10,6,0,edgeCount
20,197,243,graphml/Cogentco.graphml,2,,clustered,0.4;-0.3,31,38,15,16,2,31,16,31,38,16,2,edgeCount
19,197,243,graphml/Cogentco.graphml,3,,clustered,0.4;-0.3,6,7,6,0,0,6,0,6,6,0,0,edgeCount
18,197,243,graphml/Cogentco.graphml,2,,clustered,0.4;-0.3,6,6,6,0,0,6,0,6,6,0,0,edgeCount
17,197,243,graphml/Cogentco.graphml,1,,clustered,0.4;-0.3,14,14,14,0,2,14,0,14,14,0,2,edgeCount
16,197,243,graphml/Cogentco.graphml,2,,clustered,0.4;-0.3,18,18,18,0,6,-1,-19,58,58,40,6,edgeCount
15,197,243,graphml/Cogentco.graphml,1,,clustered,0.4;-0.3,10,10,10,0,0,10,0,10,10,0,0,edgeCount
14,197,243,graphml/Cogentco.graphml,2,,clustered,0.4;-0.3,5,5,5,0,0,5,0,5,5,0,0,edgeCount
13,197,243,graphml/Cogentco.graphml,2,,clustered,0.4;-0.3,8,8,8,0,0,8,0,8,8,0,0,edgeCount
12,197,243,graphml/Cogentco.graphml,1,,clustered,0.4;-0.3,10,10,10,0,2,10,0,10,10,0,2,edgeCount
11,197,243,graphml/Cogentco.graphml,2,,clustered,0.4;-0.3,8,5,5,3,0,5,0,5,5,0,0,edgeCount
10,197,243,graphml/Cogentco.graphml,2,,clustered,0.4;-0.3,18,18,13,5,0,18,5,18,18,5,0,edgeCount
9,197,243,graphml/Cogentco.graphml,1,,clustered,0.4;-0.3,12,19,12,0,4,-1,-13,12,19,0,4,edgeCount
8,197,243,graphml/Cogentco.graphml,1,,clustered,0.4;-0.3,6,6,6,0,0,6,0,6,6,0,0,edgeCount
7,197,243,graphml/Cogentco.graphml,1,,clustered,0.4;-0.3,4,4,4,0,0,4,0,4,4,0,0,edgeCount
6,197,243,graphml/Cogentco.graphml,3,,clustered,0.4;-0.3,13,14,9,4,2,27,18,29,27,20,2,edgeCount
5,197,243,graphml/Cogentco.graphml,1,,clustered,0.4;-0.3,13,13,13,0,2,13,0,13,13,0,2,edgeCount
4,197,243,graphml/Cogentco.graphml,2,,clustered,0.4;-0.3,23,23,20,3,0,23,3,23,23,3,0,edgeCount
3,197,243,graphml/Cogentco.graphml,2,,clustered,0.4;-0.3,5,5,5,0,2,-1,-6,20,20,15,2,edgeCount
2,197,243,graphml/Cogentco.graphml,2,,clustered,0.4;-0.3,18,28,17,1,2,18,1,18,28,1,2,edgeCount
1,197,243,graphml/Cogentco.graphml,1,,clustered,0.4;-0.3,67,69,25,42,4,-1,-26,67,69,42,4,edgeCount
