rep,nrNodes,nrEdges,edgeProb,nrPaths,nrFails,failureModel,failurePercent,hopsRanked,hopsUnranked,spLength,stretch_mult,nodeAdditions,hopsPath,stretch_path,hopsRankedOne,hopsUnrankedOne,stretch_one,overallNodeAdditionsOne,treeChoice
200,50,200,8,8,133,random,-1,-1,-1,6,-7,0,-1,-7,-1,-1,-7,0,edgeCount
199,50,200,8,8,133,random,-1,4,6,2,2,0,2,0,4,2,2,0,edgeCount
198,50,200,8,8,133,random,-1,-1,-1,6,-7,0,-1,-7,-1,-1,-7,0,edgeCount
197,50,200,8,8,133,random,-1,-1,-1,5,-6,0,-1,-6,-1,-1,-6,0,edgeCount
196,50,200,8,8,133,random,-1,-1,-1,5,-6,0,-1,-6,-1,-1,-6,0,edgeCount
195,50,200,8,8,133,random,-1,6,2,2,4,0,2,0,2,2,0,0,edgeCount
194,50,200,8,8,133,random,-1,-1,-1,5,-6,0,-1,-6,-1,-1,-6,0,edgeCount
193,50,200,8,8,133,random,-1,-1,-1,7,-8,0,-1,-8,-1,-1,-8,0,edgeCount
192,50,200,8,8,133,random,-1,-1,-1,6,-7,0,-1,-7,-1,-1,-7,0,edgeCount
191,50,200,8,8,133,random,-1,-1,-1,6,-7,0,-1,-7,-1,-1,-7,0,edgeCount
190,50,200,8,8,133,random,-1,9,5,2,7,0,2,0,3,2,1,0,edgeCount
189,50,200,8,8,133,random,-1,-1,-1,5,-6,0,-1,-6,-1,-1,-6,0,edgeCount
188,50,200,8,8,133,random,-1,-1,-1,-1,0,0,-1,0,-1,-1,0,0,edgeCount
187,50,200,8,8,133,random,-1,19,4,3,16,0,3,0,3,3,0,0,edgeCount
186,50,200,8,8,133,random,-1,4,14,4,0,0,10,6,10,6,6,0,edgeCount
185,50,200,8,8,133,random,-1,12,6,4,8,0,6,2,6,6,2,0,edgeCount
184,50,200,8,8,133,random,-1,-1,-1,-1,0,0,-1,0,-1,-1,0,0,edgeCount
183,50,200,8,8,133,random,-1,-1,-1,5,-6,0,-1,-6,-1,-1,-6,0,edgeCount
182,50,200,8,8,133,random,-1,-1,-1,4,-5,0,-1,-5,-1,-1,-5,0,edgeCount
181,50,200,8,8,133,random,-1,4,2,2,2,0,2,0,2,2,0,0,edgeCount
180,50,200,8,8,133,random,-1,-1,-1,-1,0,0,-1,0,-1,-1,0,0,edgeCount
179,50,200,8,8,133,random,-1,5,7,3,2,0,5,2,5,5,2,0,edgeCount
178,50,200,8,8,133,random,-1,6,4,4,2,0,6,2,6,6,2,0,edgeCount
177,50,200,8,8,133,random,-1,-1,-1,5,-6,0,-1,-6,-1,-1,-6,0,edgeCount
176,50,200,8,8,133,random,-1,-1,-1,6,-7,0,-1,-7,-1,-1,-7,0,edgeCount
175,50,200,8,8,133,random,-1,8,6,2,6,0,2,0,6,2,4,0,edgeCount
174,50,200,8,8,133,random,-1,-1,-1,5,-6,0,-1,-6,-1,-1,-6,0,edgeCount
173,50,200,8,8,133,random,-1,20,6,4,16,0,-1,-5,-1,-1,-5,0,edgeCount
172,50,200,8,8,133,random,-1,-1,-1,4,-5,0,-1,-5,-1,-1,-5,0,edgeCount
171,50,200,8,8,133,random,-1,-1,-1,7,-8,0,-1,-8,-1,-1,-8,0,edgeCount
170,50,200,8,8,133,random,-1,-1,-1,4,-5,0,-1,-5,-1,-1,-5,0,edgeCount
169,50,200,8,8,133,random,-1,-1,-1,4,-5,0,-1,-5,-1,-1,-5,0,edgeCount
168,50,200,8,8,133,random,-1,9,6,3,6,0,3,0,3,3,0,0,edgeCount
167,50,200,8,8,133,random,-1,10,8,2,8,0,2,0,2,2,0,0,edgeCount
166,50,200,8,8,133,random,-1,-1,-1,6,-7,0,-1,-7,-1,-1,-7,0,edgeCount
165,50,200,8,8,133,random,-1,6,2,2,4,0,2,0,2,2,0,0,edgeCount
164,50,200,8,8,133,random,-1,2,2,2,0,0,2,0,2,2,0,0,edgeCount
163,50,200,8,8,133,random,-1,-1,-1,-1,0,0,-1,0,-1,-1,0,0,edgeCount
162,50,200,8,8,133,random,-1,-1,-1,5,-6,0,-1,-6,-1,-1,-6,0,edgeCount
161,50,200,8,8,133,random,-1,-1,-1,-1,0,0,-1,0,-1,-1,0,0,edgeCount
160,50,200,8,8,133,random,-1,3,9,3,0,0,-1,-4,7,3,4,0,edgeCount
159,50,200,8,8,133,random,-1,5,5,3,2,0,-1,-4,-1,-1,-4,0,edgeCount
158,50,200,8,8,133,random,-1,9,5,2,7,0,4,2,4,4,2,0,edgeCount
157,50,200,8,8,133,random,-1,12,12,2,10,0,2,0,4,2,2,0,edgeCount
156,50,200,8,8,133,random,-1,-1,-1,6,-7,0,-1,-7,-1,-1,-7,0,edgeCount
155,50,200,8,8,133,random,-1,-1,-1,6,-7,0,-1,-7,-1,-1,-7,0,edgeCount
154,50,200,8,8,133,random,-1,-1,-1,6,-7,0,-1,-7,-1,-1,-7,0,edgeCount
153,50,200,8,8,133,random,-1,-1,-1,5,-6,0,-1,-6,-1,-1,-6,0,edgeCount
152,50,200,8,8,133,random,-1,-1,-1,4,-5,0,-1,-5,-1,-1,-5,0,edgeCount
151,50,200,8,8,133,random,-1,-1,-1,-1,0,0,-1,0,-1,-1,0,0,edgeCount
150,50,200,8,8,133,random,-1,-1,-1,4,-5,0,-1,-5,-1,-1,-5,0,edgeCount
149,50,200,8,8,133,random,-1,-1,-1,7,-8,0,-1,-8,-1,-1,-8,0,edgeCount
148,50,200,8,8,133,random,-1,-1,-1,5,-6,0,-1,-6,-1,-1,-6,0,edgeCount
147,50,200,8,8,133,random,-1,-1,-1,6,-7,0,-1,-7,-1,-1,-7,0,edgeCount
146,50,200,8,8,133,random,-1,-1,-1,5,-6,0,-1,-6,-1,-1,-6,0,edgeCount
145,50,200,8,8,133,random,-1,15,9,4,11,0,-1,-5,-1,-1,-5,0,edgeCount
144,50,200,8,8,133,random,-1,7,7,3,4,0,3,0,3,3,0,0,edgeCount
143,50,200,8,8,133,random,-1,14,4,4,10,0,-1,-5,-1,-1,-5,0,edgeCount
142,50,200,8,8,133,random,-1,6,2,2,4,0,2,0,2,2,0,0,edgeCount
141,50,200,8,8,133,random,-1,-1,-1,4,-5,0,-1,-5,-1,-1,-5,0,edgeCount
140,50,200,8,8,133,random,-1,9,3,3,6,0,3,0,3,3,0,0,edgeCount
139,50,200,8,8,133,random,-1,11,7,3,8,0,5,2,3,5,0,0,edgeCount
138,50,200,8,8,133,random,-1,-1,-1,5,-6,0,-1,-6,-1,-1,-6,0,edgeCount
137,50,200,8,8,133,random,-1,-1,-1,-1,0,0,-1,0,-1,-1,0,0,edgeCount
136,50,200,8,8,133,random,-1,-1,-1,6,-7,0,-1,-7,-1,-1,-7,0,edgeCount
135,50,200,8,8,133,random,-1,-1,-1,4,-5,0,-1,-5,-1,-1,-5,0,edgeCount
134,50,200,8,8,133,random,-1,7,3,3,4,0,7,4,7,7,4,0,edgeCount
133,50,200,8,8,133,random,-1,-1,-1,4,-5,0,-1,-5,-1,-1,-5,0,edgeCount
132,50,200,8,8,133,random,-1,-1,-1,5,-6,0,-1,-6,-1,-1,-6,0,edgeCount
131,50,200,8,8,133,random,-1,-1,-1,6,-7,0,-1,-7,-1,-1,-7,0,edgeCount
130,50,200,8,8,133,random,-1,-1,-1,6,-7,0,-1,-7,-1,-1,-7,0,edgeCount
129,50,200,8,8,133,random,-1,-1,-1,4,-5,0,-1,-5,-1,-1,-5,0,edgeCount
128,50,200,8,8,133,random,-1,7,9,2,5,0,2,0,6,2,4,0,edgeCount
127,50,200,8,8,133,random,-1,-1,-1,4,-5,0,-1,-5,-1,-1,-5,0,edgeCount
126,50,200,8,8,133,random,-1,-1,-1,5,-6,0,-1,-6,-1,-1,-6,0,edgeCount
125,50,200,8,8,133,random,-1,-1,-1,4,-5,0,-1,-5,-1,-1,-5,0,edgeCount
124,50,200,8,8,133,random,-1,-1,-1,-1,0,0,-1,0,-1,-1,0,0,edgeCount
123,50,200,8,8,133,random,-1,-1,-1,4,-5,0,-1,-5,-1,-1,-5,0,edgeCount
122,50,200,8,8,133,random,-1,11,3,3,8,0,3,0,3,3,0,0,edgeCount
121,50,200,8,8,133,random,-1,10,8,4,6,0,-1,-5,-1,-1,-5,0,edgeCount
120,50,200,8,8,133,random,-1,-1,-1,6,-7,0,-1,-7,-1,-1,-7,0,edgeCount
119,50,200,8,8,133,random,-1,24,16,2,22,0,2,0,6,2,4,0,edgeCount
118,50,200,8,8,133,random,-1,-1,-1,-1,0,0,-1,0,-1,-1,0,0,edgeCount
117,50,200,8,8,133,random,-1,13,5,3,10,0,7,4,7,7,4,0,edgeCount
116,50,200,8,8,133,random,-1,7,7,5,2,0,-1,-6,-1,-1,-6,0,edgeCount
115,50,200,8,8,133,random,-1,-1,-1,5,-6,0,-1,-6,-1,-1,-6,0,edgeCount
114,50,200,8,8,133,random,-1,-1,-1,5,-6,0,-1,-6,-1,-1,-6,0,edgeCount
113,50,200,8,8,133,random,-1,-1,-1,6,-7,0,-1,-7,-1,-1,-7,0,edgeCount
112,50,200,8,8,133,random,-1,-1,-1,5,-6,0,-1,-6,-1,-1,-6,0,edgeCount
111,50,200,8,8,133,random,-1,-1,-1,5,-6,0,-1,-6,-1,-1,-6,0,edgeCount
110,50,200,8,8,133,random,-1,-1,-1,5,-6,0,-1,-6,-1,-1,-6,0,edgeCount
109,50,200,8,8,133,random,-1,-1,-1,4,-5,0,-1,-5,-1,-1,-5,0,edgeCount
108,50,200,8,8,133,random,-1,-1,-1,-1,0,0,-1,0,-1,-1,0,0,edgeCount
107,50,200,8,8,133,random,-1,-1,-1,4,-5,0,-1,-5,-1,-1,-5,0,edgeCount
106,50,200,8,8,133,random,-1,-1,-1,3,-4,0,-1,-4,-1,-1,-4,0,edgeCount
105,50,200,8,8,133,random,-1,-1,-1,4,-5,0,-1,-5,-1,-1,-5,0,edgeCount
104,50,200,8,8,133,random,-1,3,7,3,0,0,5,2,3,3,0,0,edgeCount
103,50,200,8,8,133,random,-1,-1,-1,-1,0,0,-1,0,-1,-1,0,0,edgeCount
102,50,200,8,8,133,random,-1,6,2,2,4,0,2,0,2,2,0,0,edgeCount
101,50,200,8,8,133,random,-1,-1,-1,5,-6,0,-1,-6,-1,-1,-6,0,edgeCount
100,50,200,8,8,133,random,-1,6,2,2,4,0,2,0,2,2,0,0,edgeCount
99,50,200,8,8,133,random,-1,9,7,5,4,0,-1,-6,-1,-1,-6,0,edgeCount
98,50,200,8,8,133,random,-1,5,9,2,3,0,2,0,2,2,0,0,edgeCount
97,50,200,8,8,133,random,-1,3,3,3,0,0,-1,-4,-1,-1,-4,0,edgeCount
96,50,200,8,8,133,random,-1,4,8,2,2,0,2,0,4,2,2,0,edgeCount
95,50,200,8,8,133,random,-1,-1,-1,4,-5,0,-1,-5,-1,-1,-5,0,edgeCount
94,50,200,8,8,133,random,-1,-1,-1,7,-8,0,-1,-8,-1,-1,-8,0,edgeCount
93,50,200,8,8,133,random,-1,-1,-1,5,-6,0,-1,-6,-1,-1,-6,0,edgeCount
92,50,200,8,8,133,random,-1,10,8,2,8,0,4,2,4,4,2,0,edgeCount
91,50,200,8,8,133,random,-1,9,3,3,6,0,3,0,3,3,0,0,edgeCount
90,50,200,8,8,133,random,-1,-1,-1,5,-6,0,-1,-6,-1,-1,-6,0,edgeCount
89,50,200,8,8,133,random,-1,2,2,2,0,0,2,0,2,2,0,0,edgeCount
88,50,200,8,8,133,random,-1,-1,-1,4,-5,0,-1,-5,-1,-1,-5,0,edgeCount
87,50,200,8,8,133,random,-1,4,8,4,0,0,6,2,6,6,2,0,edgeCount
86,50,200,8,8,133,random,-1,-1,-1,5,-6,0,-1,-6,-1,-1,-6,0,edgeCount
85,50,200,8,8,133,random,-1,3,17,3,0,0,13,10,13,13,10,0,edgeCount
84,50,200,8,8,133,random,-1,-1,-1,3,-4,0,-1,-4,-1,-1,-4,0,edgeCount
83,50,200,8,8,133,random,-1,-1,-1,4,-5,0,-1,-5,-1,-1,-5,0,edgeCount
82,50,200,8,8,133,random,-1,4,4,4,0,0,4,0,4,4,0,0,edgeCount
81,50,200,8,8,133,random,-1,-1,-1,4,-5,0,-1,-5,-1,-1,-5,0,edgeCount
80,50,200,8,8,133,random,-1,-1,-1,8,-9,0,-1,-9,-1,-1,-9,0,edgeCount
79,50,200,8,8,133,random,-1,4,2,2,2,0,2,0,2,2,0,0,edgeCount
78,50,200,8,8,133,random,-1,-1,-1,3,-4,0,-1,-4,-1,-1,-4,0,edgeCount
77,50,200,8,8,133,random,-1,-1,-1,4,-5,0,-1,-5,-1,-1,-5,0,edgeCount
76,50,200,8,8,133,random,-1,-1,-1,3,-4,0,-1,-4,-1,-1,-4,0,edgeCount
75,50,200,8,8,133,random,-1,7,3,3,4,0,3,0,3,3,0,0,edgeCount
74,50,200,8,8,133,random,-1,-1,-1,5,-6,0,-1,-6,-1,-1,-6,0,edgeCount
73,50,200,8,8,133,random,-1,-1,-1,6,-7,0,-1,-7,-1,-1,-7,0,edgeCount
72,50,200,8,8,133,random,-1,-1,-1,5,-6,0,-1,-6,-1,-1,-6,0,edgeCount
71,50,200,8,8,133,random,-1,-1,-1,4,-5,0,-1,-5,-1,-1,-5,0,edgeCount
70,50,200,8,8,133,random,-1,-1,-1,6,-7,0,-1,-7,-1,-1,-7,0,edgeCount
69,50,200,8,8,133,random,-1,4,14,4,0,0,10,6,10,10,6,0,edgeCount
68,50,200,8,8,133,random,-1,-1,-1,-1,0,0,-1,0,-1,-1,0,0,edgeCount
67,50,200,8,8,133,random,-1,-1,-1,4,-5,0,-1,-5,-1,-1,-5,0,edgeCount
66,50,200,8,8,133,random,-1,15,5,4,11,0,-1,-5,-1,-1,-5,0,edgeCount
65,50,200,8,8,133,random,-1,-1,-1,5,-6,0,-1,-6,-1,-1,-6,0,edgeCount
64,50,200,8,8,133,random,-1,2,2,2,0,0,2,0,2,2,0,0,edgeCount
63,50,200,8,8,133,random,-1,-1,-1,3,-4,0,-1,-4,-1,-1,-4,0,edgeCount
62,50,200,8,8,133,random,-1,-1,-1,4,-5,0,-1,-5,-1,-1,-5,0,edgeCount
61,50,200,8,8,133,random,-1,13,7,3,10,0,3,0,3,3,0,0,edgeCount
60,50,200,8,8,133,random,-1,-1,-1,4,-5,0,-1,-5,-1,-1,-5,0,edgeCount
59,50,200,8,8,133,random,-1,-1,-1,5,-6,0,-1,-6,-1,-1,-6,0,edgeCount
58,50,200,8,8,133,random,-1,12,4,4,8,0,-1,-5,-1,-1,-5,0,edgeCount
57,50,200,8,8,133,random,-1,-1,-1,-1,0,0,-1,0,-1,-1,0,0,edgeCount
56,50,200,8,8,133,random,-1,-1,-1,7,-8,0,-1,-8,-1,-1,-8,0,edgeCount
55,50,200,8,8,133,random,-1,-1,-1,5,-6,0,-1,-6,-1,-1,-6,0,edgeCount
54,50,200,8,8,133,random,-1,10,8,2,8,0,2,0,4,2,2,0,edgeCount
53,50,200,8,8,133,random,-1,-1,-1,5,-6,0,-1,-6,-1,-1,-6,0,edgeCount
52,50,200,8,8,133,random,-1,11,3,3,8,0,5,2,3,5,0,0,edgeCount
51,50,200,8,8,133,random,-1,-1,-1,4,-5,0,-1,-5,-1,-1,-5,0,edgeCount
50,50,200,8,8,133,random,-1,-1,-1,4,-5,0,-1,-5,-1,-1,-5,0,edgeCount
49,50,200,8,8,133,random,-1,12,10,4,8,0,-1,-5,-1,-1,-5,0,edgeCount
48,50,200,8,8,133,random,-1,8,6,2,6,0,4,2,6,4,4,0,edgeCount
47,50,200,8,8,133,random,-1,-1,-1,5,-6,0,-1,-6,-1,-1,-6,0,edgeCount
46,50,200,8,8,133,random,-1,-1,-1,5,-6,0,-1,-6,-1,-1,-6,0,edgeCount
45,50,200,8,8,133,random,-1,5,9,3,2,0,5,2,3,5,0,0,edgeCount
44,50,200,8,8,133,random,-1,4,8,4,0,0,6,2,6,6,2,0,edgeCount
43,50,200,8,8,133,random,-1,13,5,3,10,0,3,0,3,3,0,0,edgeCount
42,50,200,8,8,133,random,-1,-1,-1,6,-7,0,-1,-7,-1,-1,-7,0,edgeCount
41,50,200,8,8,133,random,-1,-1,-1,4,-5,0,-1,-5,-1,-1,-5,0,edgeCount
40,50,200,8,8,133,random,-1,6,6,4,2,0,-1,-5,-1,-1,-5,0,edgeCount
39,50,200,8,8,133,random,-1,-1,-1,4,-5,0,-1,-5,-1,-1,-5,0,edgeCount
38,50,200,8,8,133,random,-1,-1,-1,4,-5,0,-1,-5,-1,-1,-5,0,edgeCount
37,50,200,8,8,133,random,-1,10,10,2,8,0,2,0,4,2,2,0,edgeCount
36,50,200,8,8,133,random,-1,-1,-1,7,-8,0,-1,-8,-1,-1,-8,0,edgeCount
35,50,200,8,8,133,random,-1,13,9,3,10,0,3,0,3,3,0,0,edgeCount
34,50,200,8,8,133,random,-1,-1,-1,4,-5,0,-1,-5,-1,-1,-5,0,edgeCount
33,50,200,8,8,133,random,-1,-1,-1,4,-5,0,-1,-5,-1,-1,-5,0,edgeCount
32,50,200,8,8,133,random,-1,11,3,3,8,0,5,2,3,5,0,0,edgeCount
31,50,200,8,8,133,random,-1,3,3,3,0,0,-1,-4,5,5,2,0,edgeCount
30,50,200,8,8,133,random,-1,-1,-1,6,-7,0,-1,-7,-1,-1,-7,0,edgeCount
29,50,200,8,8,133,random,-1,-1,-1,4,-5,0,-1,-5,-1,-1,-5,0,edgeCount
28,50,200,8,8,133,random,-1,-1,-1,6,-7,0,-1,-7,-1,-1,-7,0,edgeCount
27,50,200,8,8,133,random,-1,-1,-1,5,-6,0,-1,-6,-1,-1,-6,0,edgeCount
26,50,200,8,8,133,random,-1,5,3,3,2,0,3,0,5,5,2,0,edgeCount
25,50,200,8,8,133,random,-1,-1,-1,6,-7,0,-1,-7,-1,-1,-7,0,edgeCount
24,50,200,8,8,133,random,-1,13,13,3,10,0,5,2,5,5,2,0,edgeCount
23,50,200,8,8,133,random,-1,-1,-1,6,-7,0,-1,-7,-1,-1,-7,0,edgeCount
22,50,200,8,8,133,random,-1,-1,-1,4,-5,0,-1,-5,-1,-1,-5,0,edgeCount
21,50,200,8,8,133,random,-1,4,2,2,2,0,2,0,6,2,4,0,edgeCount
20,50,200,8,8,133,random,-1,-1,-1,4,-5,0,-1,-5,-1,-1,-5,0,edgeCount
19,50,200,8,8,133,random,-1,4,6,4,0,0,-1,-5,-1,-1,-5,0,edgeCount
18,50,200,8,8,133,random,-1,3,7,3,0,0,3,0,3,3,0,0,edgeCount
17,50,200,8,8,133,random,-1,8,5,2,6,0,2,0,3,2,1,0,edgeCount
16,50,200,8,8,133,random,-1,-1,-1,3,-4,0,-1,-4,-1,-1,-4,0,edgeCount
15,50,200,8,8,133,random,-1,-1,-1,4,-5,0,-1,-5,-1,-1,-5,0,edgeCount
14,50,200,8,8,133,random,-1,-1,-1,5,-6,0,-1,-6,-1,-1,-6,0,edgeCount
13,50,200,8,8,133,random,-1,-1,-1,4,-5,0,-1,-5,-1,-1,-5,0,edgeCount
12,50,200,8,8,133,random,-1,3,5,3,0,0,5,2,5,5,2,0,edgeCount
11,50,200,8,8,133,random,-1,-1,-1,6,-7,0,-1,-7,-1,-1,-7,0,edgeCount
10,50,200,8,8,133,random,-1,-1,-1,3,-4,0,-1,-4,-1,-1,-4,0,edgeCount
9,50,200,8,8,133,random,-1,-1,-1,5,-6,0,-1,-6,-1,-1,-6,0,edgeCount
8,50,200,8,8,133,random,-1,6,2,2,4,0,2,0,2,2,0,0,edgeCount
7,50,200,8,8,133,random,-1,-1,-1,5,-6,0,-1,-6,-1,-1,-6,0,edgeCount
6,50,200,8,8,133,random,-1,-1,-1,4,-5,0,-1,-5,-1,-1,-5,0,edgeCount
5,50,200,8,8,133,random,-1,7,3,3,4,0,3,0,3,3,0,0,edgeCount
4,50,200,8,8,133,random,-1,-1,-1,7,-8,0,-1,-8,-1,-1,-8,0,edgeCount
3,50,200,8,8,133,random,-1,-1,-1,7,-8,0,-1,-8,-1,-1,-8,0,edgeCount
2,50,200,8,8,133,random,-1,3,3,3,0,0,3,0,3,3,0,0,edgeCount
1,50,200,8,8,133,random,-1,-1,-1,-1,0,0,-1,0,-1,-1,0,0,edgeCount
