rep,nrNodes,nrEdges,edgeProb,nrPaths,nrFails,failureModel,failurePercent,hopsRanked,hopsUnranked,spLength,stretch_mult,nodeAdditions,hopsPath,stretch_path,hopsRankedOne,hopsUnrankedOne,stretch_one,overallNodeAdditionsOne,treeChoice
500,197,243,graphml/Cogentco.graphml,2,2,random,-1,21,17,17,4,2,17,0,21,17,4,2,edgeCount
499,197,243,graphml/Cogentco.graphml,1,0,random,-1,16,27,16,0,4,16,0,16,27,0,4,edgeCount
498,197,243,graphml/Cogentco.graphml,2,2,random,-1,24,24,13,11,2,24,11,24,24,11,2,edgeCount
497,197,243,graphml/Cogentco.graphml,2,2,random,-1,7,9,3,4,0,3,0,3,3,0,0,edgeCount
496,197,243,graphml/Cogentco.graphml,2,2,random,-1,6,6,6,0,0,6,0,6,6,0,0,edgeCount
495,197,243,graphml/Cogentco.graphml,2,2,random,-1,12,15,9,3,0,9,0,9,9,0,0,edgeCount
494,197,243,graphml/Cogentco.graphml,2,2,random,-1,6,6,6,0,0,6,0,6,6,0,0,edgeCount
493,197,243,graphml/Cogentco.graphml,2,2,random,-1,16,16,16,0,0,16,0,16,16,0,0,edgeCount
492,197,243,graphml/Cogentco.graphml,2,2,random,-1,9,9,8,1,0,9,1,9,9,1,0,edgeCount
491,197,243,graphml/Cogentco.graphml,2,2,random,-1,12,12,12,0,0,14,2,12,12,0,0,edgeCount
490,197,243,graphml/Cogentco.graphml,2,2,random,-1,22,20,13,9,6,22,9,22,20,9,6,edgeCount
489,197,243,graphml/Cogentco.graphml,1,0,random,-1,14,14,14,0,0,14,0,14,14,0,0,edgeCount
488,197,243,graphml/Cogentco.graphml,2,2,random,-1,8,8,6,2,0,8,2,8,8,2,0,edgeCount
487,197,243,graphml/Cogentco.graphml,1,0,random,-1,4,17,4,0,4,4,0,4,17,0,4,edgeCount
486,197,243,graphml/Cogentco.graphml,2,2,random,-1,16,19,10,6,0,10,0,10,10,0,0,edgeCount
485,197,243,graphml/Cogentco.graphml,1,0,random,-1,12,12,12,0,0,12,0,12,12,0,0,edgeCount
484,197,243,graphml/Cogentco.graphml,1,0,random,-1,9,9,9,0,0,9,0,9,9,0,0,edgeCount
483,197,243,graphml/Cogentco.graphml,2,2,random,-1,7,7,7,0,0,7,0,7,7,0,0,edgeCount
482,197,243,graphml/Cogentco.graphml,2,2,random,-1,2,2,2,0,2,2,0,2,2,0,2,edgeCount
481,197,243,graphml/Cogentco.graphml,2,2,random,-1,10,10,9,1,0,10,1,10,10,1,0,edgeCount
480,197,243,graphml/Cogentco.graphml,2,2,random,-1,11,11,11,0,0,11,0,11,11,0,0,edgeCount
479,197,243,graphml/Cogentco.graphml,2,2,random,-1,6,6,2,4,0,2,0,2,2,0,0,edgeCount
478,197,243,graphml/Cogentco.graphml,1,0,random,-1,8,8,8,0,0,8,0,8,8,0,0,edgeCount
477,197,243,graphml/Cogentco.graphml,1,0,random,-1,9,9,9,0,4,9,0,9,9,0,4,edgeCount
476,197,243,graphml/Cogentco.graphml,3,4,random,-1,19,8,8,11,0,8,0,8,8,0,0,edgeCount
475,197,243,graphml/Cogentco.graphml,1,0,random,-1,21,21,21,0,0,21,0,21,21,0,0,edgeCount
474,197,243,graphml/Cogentco.graphml,2,2,random,-1,17,17,17,0,0,17,0,17,17,0,0,edgeCount
473,197,243,graphml/Cogentco.graphml,2,2,random,-1,24,27,18,6,2,20,2,24,27,6,2,edgeCount
472,197,243,graphml/Cogentco.graphml,2,2,random,-1,2,2,2,0,0,2,0,2,2,0,0,edgeCount
471,197,243,graphml/Cogentco.graphml,2,2,random,-1,15,14,12,3,2,13,1,13,13,1,2,edgeCount
470,197,243,graphml/Cogentco.graphml,3,4,random,-1,9,15,4,5,0,8,4,8,8,4,0,edgeCount
469,197,243,graphml/Cogentco.graphml,1,0,random,-1,7,12,7,0,2,7,0,7,12,0,2,edgeCount
468,197,243,graphml/Cogentco.graphml,1,0,random,-1,16,16,16,0,0,16,0,16,16,0,0,edgeCount
467,197,243,graphml/Cogentco.graphml,3,4,random,-1,6,5,5,1,8,5,0,6,5,1,8,edgeCount
466,197,243,graphml/Cogentco.graphml,1,0,random,-1,10,10,10,0,0,10,0,10,10,0,0,edgeCount
465,197,243,graphml/Cogentco.graphml,2,2,random,-1,20,20,19,1,0,20,1,20,20,1,0,edgeCount
464,197,243,graphml/Cogentco.graphml,2,2,random,-1,10,10,6,4,0,10,4,10,10,4,0,edgeCount
463,197,243,graphml/Cogentco.graphml,2,2,random,-1,8,8,8,0,0,8,0,8,8,0,0,edgeCount
462,197,243,graphml/Cogentco.graphml,1,0,random,-1,15,15,15,0,0,15,0,15,15,0,0,edgeCount
461,197,243,graphml/Cogentco.graphml,2,2,random,-1,16,16,14,2,0,16,2,16,16,2,0,edgeCount
460,197,243,graphml/Cogentco.graphml,2,2,random,-1,11,11,11,0,0,11,0,11,11,0,0,edgeCount
459,197,243,graphml/Cogentco.graphml,2,2,random,-1,17,17,17,0,0,17,0,17,17,0,0,edgeCount
458,197,243,graphml/Cogentco.graphml,3,4,random,-1,4,4,2,2,0,2,0,2,2,0,0,edgeCount
457,197,243,graphml/Cogentco.graphml,1,0,random,-1,7,7,7,0,0,7,0,7,7,0,0,edgeCount
456,197,243,graphml/Cogentco.graphml,1,0,random,-1,5,5,5,0,0,5,0,5,5,0,0,edgeCount
455,197,243,graphml/Cogentco.graphml,2,2,random,-1,19,19,19,0,2,19,0,19,19,0,2,edgeCount
454,197,243,graphml/Cogentco.graphml,2,2,random,-1,12,12,7,5,0,12,5,12,12,5,0,edgeCount
453,197,243,graphml/Cogentco.graphml,3,4,random,-1,42,26,10,32,0,58,48,58,58,48,0,edgeCount
452,197,243,graphml/Cogentco.graphml,1,0,random,-1,11,11,11,0,0,11,0,11,11,0,0,edgeCount
451,197,243,graphml/Cogentco.graphml,2,2,random,-1,11,11,11,0,0,11,0,11,11,0,0,edgeCount
450,197,243,graphml/Cogentco.graphml,1,0,random,-1,14,14,14,0,16,14,0,14,14,0,16,edgeCount
449,197,243,graphml/Cogentco.graphml,2,2,random,-1,24,24,16,8,0,22,6,24,24,8,0,edgeCount
448,197,243,graphml/Cogentco.graphml,2,2,random,-1,19,19,19,0,0,19,0,19,19,0,0,edgeCount
447,197,243,graphml/Cogentco.graphml,2,2,random,-1,13,13,13,0,0,13,0,13,13,0,0,edgeCount
446,197,243,graphml/Cogentco.graphml,2,2,random,-1,18,32,17,1,0,42,25,42,42,25,0,edgeCount
445,197,243,graphml/Cogentco.graphml,2,2,random,-1,3,3,3,0,0,3,0,3,3,0,0,edgeCount
444,197,243,graphml/Cogentco.graphml,2,2,random,-1,8,3,3,5,4,3,0,3,3,0,4,edgeCount
443,197,243,graphml/Cogentco.graphml,2,2,random,-1,9,9,9,0,0,9,0,9,9,0,0,edgeCount
442,197,243,graphml/Cogentco.graphml,2,2,random,-1,9,9,7,2,0,9,2,9,9,2,0,edgeCount
441,197,243,graphml/Cogentco.graphml,2,2,random,-1,11,11,11,0,2,11,0,11,11,0,2,edgeCount
440,197,243,graphml/Cogentco.graphml,1,0,random,-1,19,19,19,0,2,19,0,19,19,0,2,edgeCount
439,197,243,graphml/Cogentco.graphml,2,2,random,-1,8,8,8,0,0,8,0,8,8,0,0,edgeCount
438,197,243,graphml/Cogentco.graphml,2,2,random,-1,12,17,11,1,4,11,0,11,11,0,4,edgeCount
437,197,243,graphml/Cogentco.graphml,2,2,random,-1,12,12,11,1,2,12,1,12,12,1,2,edgeCount
436,197,243,graphml/Cogentco.graphml,2,2,random,-1,9,9,8,1,0,9,1,9,9,1,0,edgeCount
435,197,243,graphml/Cogentco.graphml,1,0,random,-1,7,10,7,0,4,7,0,7,10,0,4,edgeCount
434,197,243,graphml/Cogentco.graphml,2,2,random,-1,13,13,12,1,0,13,1,13,13,1,0,edgeCount
433,197,243,graphml/Cogentco.graphml,2,2,random,-1,22,12,12,10,4,12,0,12,12,0,4,edgeCount
432,197,243,graphml/Cogentco.graphml,2,2,random,-1,3,3,3,0,0,3,0,3,3,0,0,edgeCount
431,197,243,graphml/Cogentco.graphml,1,0,random,-1,16,16,16,0,4,16,0,16,16,0,4,edgeCount
430,197,243,graphml/Cogentco.graphml,2,2,random,-1,6,4,4,2,0,4,0,4,4,0,0,edgeCount
429,197,243,graphml/Cogentco.graphml,2,2,random,-1,13,13,13,0,2,13,0,13,13,0,2,edgeCount
428,197,243,graphml/Cogentco.graphml,2,2,random,-1,16,16,15,1,0,16,1,16,16,1,0,edgeCount
427,197,243,graphml/Cogentco.graphml,1,0,random,-1,5,5,5,0,0,5,0,5,5,0,0,edgeCount
426,197,243,graphml/Cogentco.graphml,2,2,random,-1,19,19,15,4,0,19,4,19,19,4,0,edgeCount
425,197,243,graphml/Cogentco.graphml,2,2,random,-1,42,21,16,26,0,18,2,18,18,2,0,edgeCount
424,197,243,graphml/Cogentco.graphml,2,2,random,-1,15,15,15,0,0,15,0,15,15,0,0,edgeCount
423,197,243,graphml/Cogentco.graphml,2,2,random,-1,4,4,4,0,0,4,0,4,4,0,0,edgeCount
422,197,243,graphml/Cogentco.graphml,2,2,random,-1,9,9,9,0,2,9,0,9,9,0,2,edgeCount
421,197,243,graphml/Cogentco.graphml,2,2,random,-1,11,6,6,5,2,6,0,6,6,0,2,edgeCount
420,197,243,graphml/Cogentco.graphml,2,2,random,-1,12,12,10,2,0,12,2,12,12,2,0,edgeCount
419,197,243,graphml/Cogentco.graphml,1,0,random,-1,14,14,14,0,0,14,0,14,14,0,0,edgeCount
418,197,243,graphml/Cogentco.graphml,2,2,random,-1,20,20,19,1,0,20,1,20,20,1,0,edgeCount
417,197,243,graphml/Cogentco.graphml,2,2,random,-1,18,16,14,4,2,16,2,16,16,2,2,edgeCount
416,197,243,graphml/Cogentco.graphml,2,2,random,-1,12,12,12,0,0,12,0,12,12,0,0,edgeCount
415,197,243,graphml/Cogentco.graphml,2,2,random,-1,12,12,12,0,0,12,0,12,12,0,0,edgeCount
414,197,243,graphml/Cogentco.graphml,1,0,random,-1,9,17,9,0,2,9,0,9,17,0,2,edgeCount
413,197,243,graphml/Cogentco.graphml,1,0,random,-1,14,14,14,0,0,14,0,14,14,0,0,edgeCount
412,197,243,graphml/Cogentco.graphml,2,2,random,-1,5,15,4,1,2,4,0,5,4,1,2,edgeCount
411,197,243,graphml/Cogentco.graphml,1,0,random,-1,16,16,16,0,2,16,0,16,16,0,2,edgeCount
410,197,243,graphml/Cogentco.graphml,1,0,random,-1,6,6,6,0,8,6,0,6,6,0,8,edgeCount
409,197,243,graphml/Cogentco.graphml,1,0,random,-1,16,16,16,0,2,16,0,16,16,0,2,edgeCount
408,197,243,graphml/Cogentco.graphml,2,2,random,-1,23,30,15,8,2,15,0,15,15,0,2,edgeCount
407,197,243,graphml/Cogentco.graphml,2,2,random,-1,-1,-1,15,-16,0,-1,-16,-1,-1,-16,0,edgeCount
406,197,243,graphml/Cogentco.graphml,2,2,random,-1,14,14,14,0,0,14,0,14,14,0,0,edgeCount
405,197,243,graphml/Cogentco.graphml,2,2,random,-1,16,16,16,0,2,16,0,16,16,0,2,edgeCount
404,197,243,graphml/Cogentco.graphml,2,2,random,-1,8,8,8,0,0,8,0,8,8,0,0,edgeCount
403,197,243,graphml/Cogentco.graphml,2,2,random,-1,15,20,12,3,2,13,1,13,13,1,2,edgeCount
402,197,243,graphml/Cogentco.graphml,2,2,random,-1,4,4,4,0,0,4,0,4,4,0,0,edgeCount
401,197,243,graphml/Cogentco.graphml,2,2,random,-1,13,8,7,6,2,11,4,11,11,4,2,edgeCount
400,197,243,graphml/Cogentco.graphml,2,2,random,-1,25,25,20,5,0,25,5,25,25,5,0,edgeCount
399,197,243,graphml/Cogentco.graphml,2,2,random,-1,43,43,17,26,0,43,26,43,43,26,0,edgeCount
398,197,243,graphml/Cogentco.graphml,1,0,random,-1,18,18,18,0,0,18,0,18,18,0,0,edgeCount
397,197,243,graphml/Cogentco.graphml,2,2,random,-1,8,8,8,0,0,8,0,8,8,0,0,edgeCount
396,197,243,graphml/Cogentco.graphml,1,0,random,-1,19,19,19,0,0,19,0,19,19,0,0,edgeCount
395,197,243,graphml/Cogentco.graphml,1,0,random,-1,9,9,9,0,0,9,0,9,9,0,0,edgeCount
394,197,243,graphml/Cogentco.graphml,2,2,random,-1,9,9,9,0,0,11,2,9,9,0,0,edgeCount
393,197,243,graphml/Cogentco.graphml,2,2,random,-1,22,22,19,3,0,22,3,22,22,3,0,edgeCount
392,197,243,graphml/Cogentco.graphml,2,2,random,-1,11,11,11,0,0,11,0,11,11,0,0,edgeCount
391,197,243,graphml/Cogentco.graphml,1,0,random,-1,11,11,11,0,2,11,0,11,11,0,2,edgeCount
390,197,243,graphml/Cogentco.graphml,2,2,random,-1,10,10,10,0,0,10,0,10,10,0,0,edgeCount
389,197,243,graphml/Cogentco.graphml,2,2,random,-1,8,8,8,0,0,8,0,8,8,0,0,edgeCount
388,197,243,graphml/Cogentco.graphml,2,2,random,-1,14,14,14,0,0,17,3,14,14,0,0,edgeCount
387,197,243,graphml/Cogentco.graphml,2,2,random,-1,6,6,6,0,0,6,0,6,6,0,0,edgeCount
386,197,243,graphml/Cogentco.graphml,3,4,random,-1,19,19,14,5,0,19,5,19,19,5,0,edgeCount
385,197,243,graphml/Cogentco.graphml,3,4,random,-1,9,9,8,1,0,19,11,9,9,1,0,edgeCount
384,197,243,graphml/Cogentco.graphml,1,0,random,-1,13,13,13,0,2,13,0,13,13,0,2,edgeCount
383,197,243,graphml/Cogentco.graphml,3,4,random,-1,16,15,12,4,0,15,3,15,15,3,0,edgeCount
382,197,243,graphml/Cogentco.graphml,2,2,random,-1,16,18,12,4,2,16,4,16,16,4,2,edgeCount
381,197,243,graphml/Cogentco.graphml,1,0,random,-1,5,5,5,0,0,5,0,5,5,0,0,edgeCount
380,197,243,graphml/Cogentco.graphml,1,0,random,-1,6,6,6,0,2,6,0,6,6,0,2,edgeCount
379,197,243,graphml/Cogentco.graphml,1,0,random,-1,20,35,20,0,4,20,0,20,35,0,4,edgeCount
378,197,243,graphml/Cogentco.graphml,2,2,random,-1,16,16,13,3,0,16,3,16,16,3,0,edgeCount
377,197,243,graphml/Cogentco.graphml,2,2,random,-1,19,20,10,9,2,16,6,16,16,6,2,edgeCount
376,197,243,graphml/Cogentco.graphml,2,2,random,-1,2,2,2,0,2,2,0,2,2,0,2,edgeCount
375,197,243,graphml/Cogentco.graphml,2,2,random,-1,7,7,7,0,0,7,0,7,7,0,0,edgeCount
374,197,243,graphml/Cogentco.graphml,2,2,random,-1,23,14,14,9,0,14,0,14,14,0,0,edgeCount
373,197,243,graphml/Cogentco.graphml,1,0,random,-1,10,10,10,0,0,10,0,10,10,0,0,edgeCount
372,197,243,graphml/Cogentco.graphml,2,2,random,-1,16,16,13,3,0,16,3,16,16,3,0,edgeCount
371,197,243,graphml/Cogentco.graphml,2,2,random,-1,7,7,7,0,0,7,0,7,7,0,0,edgeCount
370,197,243,graphml/Cogentco.graphml,1,0,random,-1,23,23,23,0,0,23,0,23,23,0,0,edgeCount
369,197,243,graphml/Cogentco.graphml,2,2,random,-1,6,5,5,1,0,6,1,6,5,1,0,edgeCount
368,197,243,graphml/Cogentco.graphml,2,2,random,-1,21,21,14,7,4,45,31,45,52,31,4,edgeCount
367,197,243,graphml/Cogentco.graphml,2,2,random,-1,24,24,21,3,0,24,3,24,24,3,0,edgeCount
366,197,243,graphml/Cogentco.graphml,1,0,random,-1,7,7,7,0,2,7,0,7,7,0,2,edgeCount
365,197,243,graphml/Cogentco.graphml,1,0,random,-1,17,17,17,0,2,17,0,17,17,0,2,edgeCount
364,197,243,graphml/Cogentco.graphml,1,0,random,-1,3,3,3,0,0,3,0,3,3,0,0,edgeCount
363,197,243,graphml/Cogentco.graphml,2,2,random,-1,18,22,16,2,2,17,1,17,17,1,2,edgeCount
362,197,243,graphml/Cogentco.graphml,2,2,random,-1,21,35,17,4,0,41,24,41,41,24,0,edgeCount
361,197,243,graphml/Cogentco.graphml,2,2,random,-1,12,12,12,0,0,12,0,12,12,0,0,edgeCount
360,197,243,graphml/Cogentco.graphml,1,0,random,-1,10,10,10,0,0,10,0,10,10,0,0,edgeCount
359,197,243,graphml/Cogentco.graphml,2,2,random,-1,10,10,10,0,0,12,2,10,10,0,0,edgeCount
358,197,243,graphml/Cogentco.graphml,2,2,random,-1,11,11,11,0,2,11,0,11,11,0,2,edgeCount
357,197,243,graphml/Cogentco.graphml,1,0,random,-1,10,24,10,0,2,10,0,10,24,0,2,edgeCount
356,197,243,graphml/Cogentco.graphml,2,2,random,-1,31,23,12,19,2,15,3,15,15,3,2,edgeCount
355,197,243,graphml/Cogentco.graphml,1,0,random,-1,4,6,4,0,6,4,0,4,6,0,6,edgeCount
354,197,243,graphml/Cogentco.graphml,2,2,random,-1,16,16,11,5,0,16,5,16,16,5,0,edgeCount
353,197,243,graphml/Cogentco.graphml,2,2,random,-1,8,7,6,2,0,8,2,8,7,2,0,edgeCount
352,197,243,graphml/Cogentco.graphml,2,2,random,-1,11,22,9,2,0,9,0,9,9,0,0,edgeCount
351,197,243,graphml/Cogentco.graphml,1,0,random,-1,6,6,6,0,6,6,0,6,6,0,6,edgeCount
350,197,243,graphml/Cogentco.graphml,2,2,random,-1,12,12,12,0,0,12,0,12,12,0,0,edgeCount
349,197,243,graphml/Cogentco.graphml,1,0,random,-1,7,7,7,0,2,7,0,7,7,0,2,edgeCount
348,197,243,graphml/Cogentco.graphml,1,0,random,-1,14,14,14,0,0,14,0,14,14,0,0,edgeCount
347,197,243,graphml/Cogentco.graphml,1,0,random,-1,4,4,4,0,2,4,0,4,4,0,2,edgeCount
346,197,243,graphml/Cogentco.graphml,1,0,random,-1,5,5,5,0,0,5,0,5,5,0,0,edgeCount
345,197,243,graphml/Cogentco.graphml,1,0,random,-1,11,21,11,0,2,11,0,11,21,0,2,edgeCount
344,197,243,graphml/Cogentco.graphml,2,2,random,-1,5,5,5,0,0,5,0,5,5,0,0,edgeCount
343,197,243,graphml/Cogentco.graphml,1,0,random,-1,16,16,16,0,0,16,0,16,16,0,0,edgeCount
342,197,243,graphml/Cogentco.graphml,2,2,random,-1,26,26,22,4,0,26,4,26,26,4,0,edgeCount
341,197,243,graphml/Cogentco.graphml,2,2,random,-1,13,17,13,0,2,13,0,13,17,0,2,edgeCount
340,197,243,graphml/Cogentco.graphml,1,0,random,-1,6,6,6,0,2,6,0,6,6,0,2,edgeCount
339,197,243,graphml/Cogentco.graphml,2,2,random,-1,13,13,13,0,0,13,0,13,13,0,0,edgeCount
338,197,243,graphml/Cogentco.graphml,1,0,random,-1,8,8,8,0,0,8,0,8,8,0,0,edgeCount
337,197,243,graphml/Cogentco.graphml,2,2,random,-1,23,11,11,12,0,11,0,11,11,0,0,edgeCount
336,197,243,graphml/Cogentco.graphml,2,2,random,-1,23,26,13,10,2,13,0,13,13,0,2,edgeCount
335,197,243,graphml/Cogentco.graphml,2,2,random,-1,23,23,11,12,0,23,12,23,23,12,0,edgeCount
334,197,243,graphml/Cogentco.graphml,2,2,random,-1,21,21,20,1,0,21,1,21,21,1,0,edgeCount
333,197,243,graphml/Cogentco.graphml,3,4,random,-1,12,12,10,2,0,10,0,10,10,0,0,edgeCount
332,197,243,graphml/Cogentco.graphml,1,0,random,-1,10,10,10,0,0,10,0,10,10,0,0,edgeCount
331,197,243,graphml/Cogentco.graphml,1,0,random,-1,18,18,18,0,0,18,0,18,18,0,0,edgeCount
330,197,243,graphml/Cogentco.graphml,1,0,random,-1,9,9,9,0,0,9,0,9,9,0,0,edgeCount
329,197,243,graphml/Cogentco.graphml,2,2,random,-1,26,26,10,16,0,26,16,26,26,16,0,edgeCount
328,197,243,graphml/Cogentco.graphml,2,2,random,-1,13,13,10,3,2,13,3,13,13,3,2,edgeCount
327,197,243,graphml/Cogentco.graphml,1,0,random,-1,26,26,26,0,0,26,0,26,26,0,0,edgeCount
326,197,243,graphml/Cogentco.graphml,1,0,random,-1,10,10,10,0,4,10,0,10,10,0,4,edgeCount
325,197,243,graphml/Cogentco.graphml,2,2,random,-1,10,8,5,5,0,7,2,7,7,2,0,edgeCount
324,197,243,graphml/Cogentco.graphml,2,2,random,-1,16,16,16,0,0,16,0,16,16,0,0,edgeCount
323,197,243,graphml/Cogentco.graphml,2,2,random,-1,15,14,12,3,0,15,3,15,14,3,0,edgeCount
322,197,243,graphml/Cogentco.graphml,1,0,random,-1,19,34,19,0,2,19,0,19,34,0,2,edgeCount
321,197,243,graphml/Cogentco.graphml,1,0,random,-1,9,10,9,0,2,9,0,9,10,0,2,edgeCount
320,197,243,graphml/Cogentco.graphml,2,2,random,-1,7,6,6,1,0,6,0,6,6,0,0,edgeCount
319,197,243,graphml/Cogentco.graphml,2,2,random,-1,9,9,8,1,0,9,1,9,9,1,0,edgeCount
318,197,243,graphml/Cogentco.graphml,2,2,random,-1,6,4,4,2,0,6,2,6,4,2,0,edgeCount
317,197,243,graphml/Cogentco.graphml,2,2,random,-1,15,15,15,0,0,15,0,15,15,0,0,edgeCount
316,197,243,graphml/Cogentco.graphml,2,2,random,-1,19,14,14,5,0,14,0,14,14,0,0,edgeCount
315,197,243,graphml/Cogentco.graphml,2,2,random,-1,20,20,20,0,0,20,0,20,20,0,0,edgeCount
314,197,243,graphml/Cogentco.graphml,1,0,random,-1,5,5,5,0,0,5,0,5,5,0,0,edgeCount
313,197,243,graphml/Cogentco.graphml,2,2,random,-1,32,32,18,14,2,32,14,32,32,14,2,edgeCount
312,197,243,graphml/Cogentco.graphml,1,0,random,-1,4,4,4,0,2,4,0,4,4,0,2,edgeCount
311,197,243,graphml/Cogentco.graphml,2,2,random,-1,17,16,13,4,0,17,4,17,16,4,0,edgeCount
310,197,243,graphml/Cogentco.graphml,2,2,random,-1,8,8,8,0,0,8,0,8,8,0,0,edgeCount
309,197,243,graphml/Cogentco.graphml,2,2,random,-1,14,8,6,8,0,8,2,8,8,2,0,edgeCount
308,197,243,graphml/Cogentco.graphml,2,2,random,-1,12,12,11,1,0,12,1,12,12,1,0,edgeCount
307,197,243,graphml/Cogentco.graphml,1,0,random,-1,7,7,7,0,0,7,0,7,7,0,0,edgeCount
306,197,243,graphml/Cogentco.graphml,2,2,random,-1,15,22,11,4,0,15,4,15,15,4,0,edgeCount
305,197,243,graphml/Cogentco.graphml,1,0,random,-1,10,10,10,0,2,10,0,10,10,0,2,edgeCount
304,197,243,graphml/Cogentco.graphml,1,0,random,-1,10,10,10,0,0,10,0,10,10,0,0,edgeCount
303,197,243,graphml/Cogentco.graphml,2,2,random,-1,15,15,15,0,6,15,0,15,15,0,6,edgeCount
302,197,243,graphml/Cogentco.graphml,2,2,random,-1,45,22,15,30,2,15,0,15,15,0,2,edgeCount
301,197,243,graphml/Cogentco.graphml,1,0,random,-1,4,12,4,0,6,4,0,4,12,0,6,edgeCount
300,197,243,graphml/Cogentco.graphml,3,4,random,-1,12,8,7,5,2,8,1,8,8,1,2,edgeCount
299,197,243,graphml/Cogentco.graphml,1,0,random,-1,11,11,11,0,2,11,0,11,11,0,2,edgeCount
298,197,243,graphml/Cogentco.graphml,2,2,random,-1,23,17,17,6,2,17,0,17,17,0,2,edgeCount
297,197,243,graphml/Cogentco.graphml,1,0,random,-1,21,34,21,0,4,21,0,21,34,0,4,edgeCount
296,197,243,graphml/Cogentco.graphml,1,0,random,-1,8,8,8,0,0,8,0,8,8,0,0,edgeCount
295,197,243,graphml/Cogentco.graphml,1,0,random,-1,18,18,18,0,0,18,0,18,18,0,0,edgeCount
294,197,243,graphml/Cogentco.graphml,2,2,random,-1,4,4,2,2,4,2,0,2,2,0,4,edgeCount
293,197,243,graphml/Cogentco.graphml,1,0,random,-1,24,29,24,0,2,24,0,24,29,0,2,edgeCount
292,197,243,graphml/Cogentco.graphml,1,0,random,-1,11,11,11,0,2,11,0,11,11,0,2,edgeCount
291,197,243,graphml/Cogentco.graphml,1,0,random,-1,13,13,13,0,0,13,0,13,13,0,0,edgeCount
290,197,243,graphml/Cogentco.graphml,1,0,random,-1,12,12,12,0,0,12,0,12,12,0,0,edgeCount
289,197,243,graphml/Cogentco.graphml,1,0,random,-1,5,5,5,0,0,5,0,5,5,0,0,edgeCount
288,197,243,graphml/Cogentco.graphml,2,2,random,-1,13,14,11,2,4,11,0,11,11,0,4,edgeCount
287,197,243,graphml/Cogentco.graphml,2,2,random,-1,3,3,3,0,0,3,0,3,3,0,0,edgeCount
286,197,243,graphml/Cogentco.graphml,1,0,random,-1,8,8,8,0,2,8,0,8,8,0,2,edgeCount
285,197,243,graphml/Cogentco.graphml,1,0,random,-1,16,16,16,0,0,16,0,16,16,0,0,edgeCount
284,197,243,graphml/Cogentco.graphml,1,0,random,-1,24,24,24,0,2,24,0,24,24,0,2,edgeCount
283,197,243,graphml/Cogentco.graphml,2,2,random,-1,20,32,15,5,0,16,1,16,16,1,0,edgeCount
282,197,243,graphml/Cogentco.graphml,2,2,random,-1,15,12,12,3,2,12,0,12,12,0,2,edgeCount
281,197,243,graphml/Cogentco.graphml,1,0,random,-1,6,6,6,0,0,6,0,6,6,0,0,edgeCount
280,197,243,graphml/Cogentco.graphml,2,2,random,-1,27,17,11,16,4,11,0,11,11,0,4,edgeCount
279,197,243,graphml/Cogentco.graphml,2,2,random,-1,13,13,13,0,2,13,0,13,13,0,2,edgeCount
278,197,243,graphml/Cogentco.graphml,2,2,random,-1,14,10,10,4,2,10,0,10,10,0,2,edgeCount
277,197,243,graphml/Cogentco.graphml,2,2,random,-1,13,17,10,3,0,11,1,11,11,1,0,edgeCount
276,197,243,graphml/Cogentco.graphml,2,2,random,-1,17,17,17,0,0,17,0,17,17,0,0,edgeCount
275,197,243,graphml/Cogentco.graphml,2,2,random,-1,10,10,10,0,0,10,0,10,10,0,0,edgeCount
274,197,243,graphml/Cogentco.graphml,2,2,random,-1,2,2,2,0,0,2,0,2,2,0,0,edgeCount
273,197,243,graphml/Cogentco.graphml,2,2,random,-1,15,19,9,6,0,9,0,9,9,0,0,edgeCount
272,197,243,graphml/Cogentco.graphml,2,2,random,-1,18,22,16,2,4,16,0,16,16,0,4,edgeCount
271,197,243,graphml/Cogentco.graphml,1,0,random,-1,9,9,9,0,2,9,0,9,9,0,2,edgeCount
270,197,243,graphml/Cogentco.graphml,2,2,random,-1,15,12,7,8,2,7,0,15,12,8,2,edgeCount
269,197,243,graphml/Cogentco.graphml,2,2,random,-1,11,11,11,0,0,11,0,11,11,0,0,edgeCount
268,197,243,graphml/Cogentco.graphml,1,0,random,-1,20,20,20,0,2,20,0,20,20,0,2,edgeCount
267,197,243,graphml/Cogentco.graphml,2,2,random,-1,8,6,6,2,2,6,0,6,6,0,2,edgeCount
266,197,243,graphml/Cogentco.graphml,2,2,random,-1,10,10,10,0,0,10,0,10,10,0,0,edgeCount
265,197,243,graphml/Cogentco.graphml,1,0,random,-1,4,4,4,0,0,4,0,4,4,0,0,edgeCount
264,197,243,graphml/Cogentco.graphml,2,2,random,-1,17,17,17,0,0,17,0,17,17,0,0,edgeCount
263,197,243,graphml/Cogentco.graphml,2,2,random,-1,18,22,11,7,0,16,5,16,16,5,0,edgeCount
262,197,243,graphml/Cogentco.graphml,2,2,random,-1,16,16,16,0,0,18,2,16,16,0,0,edgeCount
261,197,243,graphml/Cogentco.graphml,1,0,random,-1,27,27,27,0,0,27,0,27,27,0,0,edgeCount
260,197,243,graphml/Cogentco.graphml,1,0,random,-1,20,20,20,0,0,20,0,20,20,0,0,edgeCount
259,197,243,graphml/Cogentco.graphml,2,2,random,-1,7,7,4,3,2,7,3,7,7,3,2,edgeCount
258,197,243,graphml/Cogentco.graphml,2,2,random,-1,22,22,19,3,0,22,3,22,22,3,0,edgeCount
257,197,243,graphml/Cogentco.graphml,2,2,random,-1,14,14,14,0,0,14,0,14,14,0,0,edgeCount
256,197,243,graphml/Cogentco.graphml,2,2,random,-1,7,7,6,1,0,7,1,7,7,1,0,edgeCount
255,197,243,graphml/Cogentco.graphml,2,2,random,-1,6,6,6,0,2,6,0,6,6,0,2,edgeCount
254,197,243,graphml/Cogentco.graphml,2,2,random,-1,8,13,7,1,0,7,0,7,7,0,0,edgeCount
253,197,243,graphml/Cogentco.graphml,2,2,random,-1,12,12,10,2,2,11,1,11,11,1,2,edgeCount
252,197,243,graphml/Cogentco.graphml,2,2,random,-1,17,21,8,9,2,10,2,17,21,9,2,edgeCount
251,197,243,graphml/Cogentco.graphml,1,0,random,-1,19,24,19,0,2,19,0,19,24,0,2,edgeCount
250,197,243,graphml/Cogentco.graphml,1,0,random,-1,11,11,11,0,2,11,0,11,11,0,2,edgeCount
249,197,243,graphml/Cogentco.graphml,2,2,random,-1,19,26,11,8,0,17,6,17,17,6,0,edgeCount
248,197,243,graphml/Cogentco.graphml,1,0,random,-1,9,12,9,0,4,9,0,9,12,0,4,edgeCount
247,197,243,graphml/Cogentco.graphml,2,2,random,-1,2,2,2,0,2,2,0,2,2,0,2,edgeCount
246,197,243,graphml/Cogentco.graphml,2,2,random,-1,3,2,2,1,0,2,0,3,2,1,0,edgeCount
245,197,243,graphml/Cogentco.graphml,1,0,random,-1,20,20,20,0,0,20,0,20,20,0,0,edgeCount
244,197,243,graphml/Cogentco.graphml,2,2,random,-1,11,8,8,3,4,8,0,11,8,3,4,edgeCount
243,197,243,graphml/Cogentco.graphml,2,2,random,-1,7,7,7,0,0,11,4,7,7,0,0,edgeCount
242,197,243,graphml/Cogentco.graphml,2,2,random,-1,3,3,3,0,0,3,0,3,3,0,0,edgeCount
241,197,243,graphml/Cogentco.graphml,2,2,random,-1,3,3,3,0,0,3,0,3,3,0,0,edgeCount
240,197,243,graphml/Cogentco.graphml,2,2,random,-1,20,28,11,9,0,11,0,11,11,0,0,edgeCount
239,197,243,graphml/Cogentco.graphml,2,2,random,-1,5,5,5,0,0,5,0,5,5,0,0,edgeCount
238,197,243,graphml/Cogentco.graphml,2,2,random,-1,3,3,3,0,0,3,0,3,3,0,0,edgeCount
237,197,243,graphml/Cogentco.graphml,1,0,random,-1,5,15,5,0,2,5,0,5,15,0,2,edgeCount
236,197,243,graphml/Cogentco.graphml,1,0,random,-1,4,4,4,0,0,4,0,4,4,0,0,edgeCount
235,197,243,graphml/Cogentco.graphml,1,0,random,-1,18,18,18,0,0,18,0,18,18,0,0,edgeCount
234,197,243,graphml/Cogentco.graphml,2,2,random,-1,30,16,15,15,4,16,1,16,16,1,4,edgeCount
233,197,243,graphml/Cogentco.graphml,1,0,random,-1,12,12,12,0,2,12,0,12,12,0,2,edgeCount
232,197,243,graphml/Cogentco.graphml,2,2,random,-1,11,11,11,0,0,11,0,11,11,0,0,edgeCount
231,197,243,graphml/Cogentco.graphml,1,0,random,-1,13,13,13,0,0,13,0,13,13,0,0,edgeCount
230,197,243,graphml/Cogentco.graphml,1,0,random,-1,9,9,9,0,0,9,0,9,9,0,0,edgeCount
229,197,243,graphml/Cogentco.graphml,3,4,random,-1,10,8,8,2,2,8,0,8,8,0,2,edgeCount
228,197,243,graphml/Cogentco.graphml,2,2,random,-1,29,9,9,20,4,9,0,9,9,0,4,edgeCount
227,197,243,graphml/Cogentco.graphml,1,0,random,-1,6,6,6,0,4,6,0,6,6,0,4,edgeCount
226,197,243,graphml/Cogentco.graphml,2,2,random,-1,18,18,17,1,2,18,1,18,18,1,2,edgeCount
225,197,243,graphml/Cogentco.graphml,1,0,random,-1,8,9,8,0,4,8,0,8,9,0,4,edgeCount
224,197,243,graphml/Cogentco.graphml,2,2,random,-1,2,2,2,0,0,2,0,2,2,0,0,edgeCount
223,197,243,graphml/Cogentco.graphml,1,0,random,-1,11,11,11,0,0,11,0,11,11,0,0,edgeCount
222,197,243,graphml/Cogentco.graphml,1,0,random,-1,6,6,6,0,2,6,0,6,6,0,2,edgeCount
221,197,243,graphml/Cogentco.graphml,1,0,random,-1,8,8,8,0,0,8,0,8,8,0,0,edgeCount
220,197,243,graphml/Cogentco.graphml,2,2,random,-1,8,8,8,0,0,8,0,8,8,0,0,edgeCount
219,197,243,graphml/Cogentco.graphml,1,0,random,-1,6,6,6,0,0,6,0,6,6,0,0,edgeCount
218,197,243,graphml/Cogentco.graphml,1,0,random,-1,18,24,18,0,2,18,0,18,24,0,2,edgeCount
217,197,243,graphml/Cogentco.graphml,1,0,random,-1,14,14,14,0,2,14,0,14,14,0,2,edgeCount
216,197,243,graphml/Cogentco.graphml,1,0,random,-1,9,10,9,0,2,9,0,9,10,0,2,edgeCount
215,197,243,graphml/Cogentco.graphml,1,0,random,-1,6,6,6,0,0,6,0,6,6,0,0,edgeCount
214,197,243,graphml/Cogentco.graphml,2,2,random,-1,20,20,14,6,4,20,6,20,22,6,4,edgeCount
213,197,243,graphml/Cogentco.graphml,2,2,random,-1,11,16,6,5,2,6,0,6,6,0,2,edgeCount
212,197,243,graphml/Cogentco.graphml,2,2,random,-1,36,36,16,20,2,36,20,36,36,20,2,edgeCount
211,197,243,graphml/Cogentco.graphml,2,2,random,-1,11,11,11,0,2,11,0,11,11,0,2,edgeCount
210,197,243,graphml/Cogentco.graphml,2,2,random,-1,16,16,16,0,0,16,0,16,16,0,0,edgeCount
209,197,243,graphml/Cogentco.graphml,2,2,random,-1,7,7,7,0,0,7,0,7,7,0,0,edgeCount
208,197,243,graphml/Cogentco.graphml,2,2,random,-1,13,16,13,0,2,13,0,13,16,0,2,edgeCount
207,197,243,graphml/Cogentco.graphml,2,2,random,-1,6,6,6,0,0,6,0,6,6,0,0,edgeCount
206,197,243,graphml/Cogentco.graphml,1,0,random,-1,9,9,9,0,2,9,0,9,9,0,2,edgeCount
205,197,243,graphml/Cogentco.graphml,2,2,random,-1,32,32,14,18,0,32,18,32,32,18,0,edgeCount
204,197,243,graphml/Cogentco.graphml,2,2,random,-1,13,13,13,0,2,13,0,13,13,0,2,edgeCount
203,197,243,graphml/Cogentco.graphml,2,2,random,-1,15,15,12,3,0,15,3,15,15,3,0,edgeCount
202,197,243,graphml/Cogentco.graphml,2,2,random,-1,10,10,10,0,0,10,0,10,10,0,0,edgeCount
201,197,243,graphml/Cogentco.graphml,1,0,random,-1,18,18,18,0,2,18,0,18,18,0,2,edgeCount
200,197,243,graphml/Cogentco.graphml,1,0,random,-1,14,14,14,0,2,14,0,14,14,0,2,edgeCount
199,197,243,graphml/Cogentco.graphml,2,2,random,-1,6,3,3,3,4,3,0,3,3,0,4,edgeCount
198,197,243,graphml/Cogentco.graphml,2,2,random,-1,18,24,13,5,2,18,5,18,18,5,2,edgeCount
197,197,243,graphml/Cogentco.graphml,1,0,random,-1,6,6,6,0,0,6,0,6,6,0,0,edgeCount
196,197,243,graphml/Cogentco.graphml,2,2,random,-1,9,9,9,0,0,9,0,9,9,0,0,edgeCount
195,197,243,graphml/Cogentco.graphml,2,2,random,-1,25,25,21,4,0,25,4,25,25,4,0,edgeCount
194,197,243,graphml/Cogentco.graphml,1,0,random,-1,4,12,4,0,4,4,0,4,12,0,4,edgeCount
193,197,243,graphml/Cogentco.graphml,3,4,random,-1,11,11,7,4,0,11,4,11,11,4,0,edgeCount
192,197,243,graphml/Cogentco.graphml,1,0,random,-1,20,20,20,0,0,20,0,20,20,0,0,edgeCount
191,197,243,graphml/Cogentco.graphml,1,0,random,-1,8,12,8,0,2,8,0,8,12,0,2,edgeCount
190,197,243,graphml/Cogentco.graphml,2,2,random,-1,4,3,3,1,4,3,0,3,3,0,4,edgeCount
189,197,243,graphml/Cogentco.graphml,2,2,random,-1,11,11,11,0,0,11,0,11,11,0,0,edgeCount
188,197,243,graphml/Cogentco.graphml,1,0,random,-1,16,16,16,0,0,16,0,16,16,0,0,edgeCount
187,197,243,graphml/Cogentco.graphml,1,0,random,-1,23,23,23,0,0,23,0,23,23,0,0,edgeCount
186,197,243,graphml/Cogentco.graphml,1,0,random,-1,9,10,9,0,2,9,0,9,10,0,2,edgeCount
185,197,243,graphml/Cogentco.graphml,3,4,random,-1,2,2,2,0,2,2,0,2,2,0,2,edgeCount
184,197,243,graphml/Cogentco.graphml,2,2,random,-1,17,17,17,0,0,17,0,17,17,0,0,edgeCount
183,197,243,graphml/Cogentco.graphml,1,0,random,-1,11,11,11,0,0,11,0,11,11,0,0,edgeCount
182,197,243,graphml/Cogentco.graphml,2,2,random,-1,17,15,13,4,2,15,2,17,15,4,2,edgeCount
181,197,243,graphml/Cogentco.graphml,2,2,random,-1,5,12,5,0,2,5,0,5,12,0,2,edgeCount
180,197,243,graphml/Cogentco.graphml,1,0,random,-1,15,15,15,0,0,15,0,15,15,0,0,edgeCount
179,197,243,graphml/Cogentco.graphml,1,0,random,-1,21,21,21,0,2,21,0,21,21,0,2,edgeCount
178,197,243,graphml/Cogentco.graphml,2,2,random,-1,11,11,11,0,0,11,0,11,11,0,0,edgeCount
177,197,243,graphml/Cogentco.graphml,2,2,random,-1,8,8,8,0,0,8,0,8,8,0,0,edgeCount
176,197,243,graphml/Cogentco.graphml,2,2,random,-1,8,8,8,0,2,11,3,11,11,3,2,edgeCount
175,197,243,graphml/Cogentco.graphml,1,0,random,-1,5,5,5,0,0,5,0,5,5,0,0,edgeCount
174,197,243,graphml/Cogentco.graphml,2,2,random,-1,13,20,8,5,2,8,0,8,8,0,2,edgeCount
173,197,243,graphml/Cogentco.graphml,2,2,random,-1,15,15,14,1,0,15,1,15,15,1,0,edgeCount
172,197,243,graphml/Cogentco.graphml,2,2,random,-1,8,8,8,0,0,8,0,8,8,0,0,edgeCount
171,197,243,graphml/Cogentco.graphml,1,0,random,-1,14,14,14,0,2,14,0,14,14,0,2,edgeCount
170,197,243,graphml/Cogentco.graphml,1,0,random,-1,10,10,10,0,0,10,0,10,10,0,0,edgeCount
169,197,243,graphml/Cogentco.graphml,2,2,random,-1,15,16,10,5,2,11,1,15,16,5,2,edgeCount
168,197,243,graphml/Cogentco.graphml,1,0,random,-1,7,7,7,0,0,7,0,7,7,0,0,edgeCount
167,197,243,graphml/Cogentco.graphml,2,2,random,-1,16,16,16,0,0,16,0,16,16,0,0,edgeCount
166,197,243,graphml/Cogentco.graphml,1,0,random,-1,17,17,17,0,0,17,0,17,17,0,0,edgeCount
165,197,243,graphml/Cogentco.graphml,1,0,random,-1,8,8,8,0,0,8,0,8,8,0,0,edgeCount
164,197,243,graphml/Cogentco.graphml,1,0,random,-1,9,9,9,0,0,9,0,9,9,0,0,edgeCount
163,197,243,graphml/Cogentco.graphml,2,2,random,-1,5,5,5,0,0,5,0,5,5,0,0,edgeCount
162,197,243,graphml/Cogentco.graphml,2,2,random,-1,12,18,10,2,0,10,0,10,10,0,0,edgeCount
161,197,243,graphml/Cogentco.graphml,2,2,random,-1,5,5,5,0,0,5,0,5,5,0,0,edgeCount
160,197,243,graphml/Cogentco.graphml,1,0,random,-1,5,5,5,0,0,5,0,5,5,0,0,edgeCount
159,197,243,graphml/Cogentco.graphml,1,0,random,-1,22,22,22,0,0,22,0,22,22,0,0,edgeCount
158,197,243,graphml/Cogentco.graphml,1,0,random,-1,5,5,5,0,0,5,0,5,5,0,0,edgeCount
157,197,243,graphml/Cogentco.graphml,2,2,random,-1,16,16,16,0,0,16,0,16,16,0,0,edgeCount
156,197,243,graphml/Cogentco.graphml,2,2,random,-1,9,7,7,2,0,7,0,7,7,0,0,edgeCount
155,197,243,graphml/Cogentco.graphml,2,2,random,-1,19,19,18,1,0,19,1,19,19,1,0,edgeCount
154,197,243,graphml/Cogentco.graphml,2,2,random,-1,9,11,5,4,0,5,0,5,5,0,0,edgeCount
153,197,243,graphml/Cogentco.graphml,2,2,random,-1,35,35,10,25,0,35,25,35,35,25,0,edgeCount
152,197,243,graphml/Cogentco.graphml,2,2,random,-1,15,17,9,6,0,9,0,9,9,0,0,edgeCount
151,197,243,graphml/Cogentco.graphml,2,2,random,-1,9,9,9,0,0,9,0,9,9,0,0,edgeCount
150,197,243,graphml/Cogentco.graphml,1,0,random,-1,19,26,19,0,4,19,0,19,26,0,4,edgeCount
149,197,243,graphml/Cogentco.graphml,1,0,random,-1,11,11,11,0,0,11,0,11,11,0,0,edgeCount
148,197,243,graphml/Cogentco.graphml,2,2,random,-1,2,4,2,0,0,4,2,4,4,2,0,edgeCount
147,197,243,graphml/Cogentco.graphml,2,2,random,-1,48,16,13,35,0,16,3,16,16,3,0,edgeCount
146,197,243,graphml/Cogentco.graphml,1,0,random,-1,12,12,12,0,2,12,0,12,12,0,2,edgeCount
145,197,243,graphml/Cogentco.graphml,2,2,random,-1,16,17,13,3,4,16,3,16,16,3,4,edgeCount
144,197,243,graphml/Cogentco.graphml,1,0,random,-1,8,8,8,0,0,8,0,8,8,0,0,edgeCount
143,197,243,graphml/Cogentco.graphml,1,0,random,-1,7,7,7,0,4,7,0,7,7,0,4,edgeCount
142,197,243,graphml/Cogentco.graphml,2,2,random,-1,25,18,14,11,2,18,4,18,18,4,2,edgeCount
141,197,243,graphml/Cogentco.graphml,1,0,random,-1,13,13,13,0,0,13,0,13,13,0,0,edgeCount
140,197,243,graphml/Cogentco.graphml,2,2,random,-1,13,13,13,0,2,13,0,13,13,0,2,edgeCount
139,197,243,graphml/Cogentco.graphml,2,2,random,-1,6,6,6,0,2,6,0,6,6,0,2,edgeCount
138,197,243,graphml/Cogentco.graphml,2,2,random,-1,10,10,10,0,2,10,0,10,10,0,2,edgeCount
137,197,243,graphml/Cogentco.graphml,2,2,random,-1,15,15,15,0,0,15,0,15,15,0,0,edgeCount
136,197,243,graphml/Cogentco.graphml,2,2,random,-1,3,3,3,0,0,3,0,3,3,0,0,edgeCount
135,197,243,graphml/Cogentco.graphml,2,2,random,-1,10,10,10,0,0,10,0,10,10,0,0,edgeCount
134,197,243,graphml/Cogentco.graphml,2,2,random,-1,4,4,4,0,0,4,0,4,4,0,0,edgeCount
133,197,243,graphml/Cogentco.graphml,1,0,random,-1,10,10,10,0,2,10,0,10,10,0,2,edgeCount
132,197,243,graphml/Cogentco.graphml,2,2,random,-1,8,8,7,1,0,8,1,8,8,1,0,edgeCount
131,197,243,graphml/Cogentco.graphml,1,0,random,-1,18,37,18,0,4,18,0,18,37,0,4,edgeCount
130,197,243,graphml/Cogentco.graphml,2,2,random,-1,13,15,13,0,0,15,2,15,15,2,0,edgeCount
129,197,243,graphml/Cogentco.graphml,2,2,random,-1,12,17,6,6,0,6,0,6,6,0,0,edgeCount
128,197,243,graphml/Cogentco.graphml,1,0,random,-1,5,5,5,0,2,5,0,5,5,0,2,edgeCount
127,197,243,graphml/Cogentco.graphml,2,2,random,-1,8,8,8,0,0,8,0,8,8,0,0,edgeCount
126,197,243,graphml/Cogentco.graphml,1,0,random,-1,10,10,10,0,0,10,0,10,10,0,0,edgeCount
125,197,243,graphml/Cogentco.graphml,2,2,random,-1,34,34,19,15,0,34,15,34,34,15,0,edgeCount
124,197,243,graphml/Cogentco.graphml,2,2,random,-1,5,5,5,0,0,5,0,5,5,0,0,edgeCount
123,197,243,graphml/Cogentco.graphml,2,2,random,-1,4,4,4,0,0,4,0,4,4,0,0,edgeCount
122,197,243,graphml/Cogentco.graphml,2,2,random,-1,35,40,17,18,2,55,38,55,55,38,2,edgeCount
121,197,243,graphml/Cogentco.graphml,1,0,random,-1,5,5,5,0,0,5,0,5,5,0,0,edgeCount
120,197,243,graphml/Cogentco.graphml,2,2,random,-1,20,20,17,3,0,22,5,20,20,3,0,edgeCount
119,197,243,graphml/Cogentco.graphml,1,0,random,-1,17,17,17,0,0,17,0,17,17,0,0,edgeCount
118,197,243,graphml/Cogentco.graphml,1,0,random,-1,15,15,15,0,0,15,0,15,15,0,0,edgeCount
117,197,243,graphml/Cogentco.graphml,1,0,random,-1,6,6,6,0,2,6,0,6,6,0,2,edgeCount
116,197,243,graphml/Cogentco.graphml,2,2,random,-1,3,3,3,0,0,3,0,3,3,0,0,edgeCount
115,197,243,graphml/Cogentco.graphml,2,2,random,-1,20,23,16,4,0,17,1,17,17,1,0,edgeCount
114,197,243,graphml/Cogentco.graphml,1,0,random,-1,20,20,20,0,0,20,0,20,20,0,0,edgeCount
113,197,243,graphml/Cogentco.graphml,2,2,random,-1,19,19,14,5,0,19,5,19,19,5,0,edgeCount
112,197,243,graphml/Cogentco.graphml,1,0,random,-1,10,10,10,0,0,10,0,10,10,0,0,edgeCount
111,197,243,graphml/Cogentco.graphml,1,0,random,-1,8,8,8,0,0,8,0,8,8,0,0,edgeCount
110,197,243,graphml/Cogentco.graphml,2,2,random,-1,14,14,13,1,0,14,1,14,14,1,0,edgeCount
109,197,243,graphml/Cogentco.graphml,2,2,random,-1,45,45,17,28,0,45,28,45,45,28,0,edgeCount
108,197,243,graphml/Cogentco.graphml,2,2,random,-1,14,15,8,6,0,10,2,10,10,2,0,edgeCount
107,197,243,graphml/Cogentco.graphml,2,2,random,-1,8,13,5,3,0,5,0,5,5,0,0,edgeCount
106,197,243,graphml/Cogentco.graphml,2,2,random,-1,20,20,20,0,0,20,0,20,20,0,0,edgeCount
105,197,243,graphml/Cogentco.graphml,1,0,random,-1,23,23,23,0,0,23,0,23,23,0,0,edgeCount
104,197,243,graphml/Cogentco.graphml,2,2,random,-1,48,48,22,26,0,48,26,48,48,26,0,edgeCount
103,197,243,graphml/Cogentco.graphml,2,2,random,-1,4,4,4,0,2,4,0,4,4,0,2,edgeCount
102,197,243,graphml/Cogentco.graphml,2,2,random,-1,6,6,6,0,0,6,0,6,6,0,0,edgeCount
101,197,243,graphml/Cogentco.graphml,1,0,random,-1,19,19,19,0,0,19,0,19,19,0,0,edgeCount
100,197,243,graphml/Cogentco.graphml,1,0,random,-1,11,11,11,0,6,11,0,11,11,0,6,edgeCount
99,197,243,graphml/Cogentco.graphml,1,0,random,-1,3,3,3,0,0,3,0,3,3,0,0,edgeCount
98,197,243,graphml/Cogentco.graphml,2,2,random,-1,6,6,6,0,0,9,3,9,6,3,0,edgeCount
97,197,243,graphml/Cogentco.graphml,2,2,random,-1,14,18,10,4,0,10,0,10,10,0,0,edgeCount
96,197,243,graphml/Cogentco.graphml,1,0,random,-1,8,11,8,0,2,8,0,8,11,0,2,edgeCount
95,197,243,graphml/Cogentco.graphml,2,2,random,-1,35,35,26,9,0,35,9,35,35,9,0,edgeCount
94,197,243,graphml/Cogentco.graphml,2,2,random,-1,12,7,7,5,4,7,0,7,7,0,4,edgeCount
93,197,243,graphml/Cogentco.graphml,2,2,random,-1,16,7,7,9,0,7,0,7,7,0,0,edgeCount
92,197,243,graphml/Cogentco.graphml,2,2,random,-1,9,4,4,5,2,4,0,4,4,0,2,edgeCount
91,197,243,graphml/Cogentco.graphml,1,0,random,-1,20,20,20,0,0,20,0,20,20,0,0,edgeCount
90,197,243,graphml/Cogentco.graphml,2,2,random,-1,4,2,2,2,4,2,0,2,2,0,4,edgeCount
89,197,243,graphml/Cogentco.graphml,1,0,random,-1,8,8,8,0,0,8,0,8,8,0,0,edgeCount
88,197,243,graphml/Cogentco.graphml,2,2,random,-1,2,2,2,0,2,2,0,2,2,0,2,edgeCount
87,197,243,graphml/Cogentco.graphml,2,2,random,-1,17,13,12,5,0,13,1,13,13,1,0,edgeCount
86,197,243,graphml/Cogentco.graphml,2,2,random,-1,6,6,6,0,0,6,0,6,6,0,0,edgeCount
85,197,243,graphml/Cogentco.graphml,1,0,random,-1,11,11,11,0,2,11,0,11,11,0,2,edgeCount
84,197,243,graphml/Cogentco.graphml,3,4,random,-1,18,9,8,10,0,9,1,9,9,1,0,edgeCount
83,197,243,graphml/Cogentco.graphml,3,4,random,-1,10,10,9,1,0,10,1,10,10,1,0,edgeCount
82,197,243,graphml/Cogentco.graphml,2,2,random,-1,58,58,21,37,2,58,37,58,58,37,2,edgeCount
81,197,243,graphml/Cogentco.graphml,2,2,random,-1,23,23,23,0,0,23,0,23,23,0,0,edgeCount
80,197,243,graphml/Cogentco.graphml,1,0,random,-1,3,3,3,0,4,3,0,3,3,0,4,edgeCount
79,197,243,graphml/Cogentco.graphml,2,2,random,-1,9,9,9,0,0,9,0,9,9,0,0,edgeCount
78,197,243,graphml/Cogentco.graphml,1,0,random,-1,8,15,8,0,4,8,0,8,15,0,4,edgeCount
77,197,243,graphml/Cogentco.graphml,1,0,random,-1,4,10,4,0,6,4,0,4,10,0,6,edgeCount
76,197,243,graphml/Cogentco.graphml,1,0,random,-1,19,19,19,0,4,19,0,19,19,0,4,edgeCount
75,197,243,graphml/Cogentco.graphml,2,2,random,-1,18,18,17,1,2,18,1,18,18,1,2,edgeCount
74,197,243,graphml/Cogentco.graphml,1,0,random,-1,4,4,4,0,0,4,0,4,4,0,0,edgeCount
73,197,243,graphml/Cogentco.graphml,1,0,random,-1,11,19,11,0,4,11,0,11,19,0,4,edgeCount
72,197,243,graphml/Cogentco.graphml,2,2,random,-1,15,15,15,0,0,15,0,15,15,0,0,edgeCount
71,197,243,graphml/Cogentco.graphml,2,2,random,-1,17,14,10,7,4,10,0,10,10,0,4,edgeCount
70,197,243,graphml/Cogentco.graphml,1,0,random,-1,13,13,13,0,0,13,0,13,13,0,0,edgeCount
69,197,243,graphml/Cogentco.graphml,2,2,random,-1,6,6,6,0,0,6,0,6,6,0,0,edgeCount
68,197,243,graphml/Cogentco.graphml,1,0,random,-1,10,10,10,0,0,10,0,10,10,0,0,edgeCount
67,197,243,graphml/Cogentco.graphml,2,2,random,-1,12,10,10,2,6,10,0,10,10,0,6,edgeCount
66,197,243,graphml/Cogentco.graphml,1,0,random,-1,9,9,9,0,0,9,0,9,9,0,0,edgeCount
65,197,243,graphml/Cogentco.graphml,2,2,random,-1,64,64,21,43,2,64,43,64,64,43,2,edgeCount
64,197,243,graphml/Cogentco.graphml,2,2,random,-1,17,17,16,1,0,17,1,17,17,1,0,edgeCount
63,197,243,graphml/Cogentco.graphml,1,0,random,-1,13,13,13,0,0,13,0,13,13,0,0,edgeCount
62,197,243,graphml/Cogentco.graphml,1,0,random,-1,9,9,9,0,2,9,0,9,9,0,2,edgeCount
61,197,243,graphml/Cogentco.graphml,2,2,random,-1,13,13,12,1,0,13,1,13,13,1,0,edgeCount
60,197,243,graphml/Cogentco.graphml,1,0,random,-1,16,16,16,0,2,16,0,16,16,0,2,edgeCount
59,197,243,graphml/Cogentco.graphml,2,2,random,-1,20,16,7,13,0,24,17,24,24,17,0,edgeCount
58,197,243,graphml/Cogentco.graphml,2,2,random,-1,13,6,6,7,2,6,0,6,6,0,2,edgeCount
57,197,243,graphml/Cogentco.graphml,1,0,random,-1,21,21,21,0,2,21,0,21,21,0,2,edgeCount
56,197,243,graphml/Cogentco.graphml,2,2,random,-1,26,26,10,16,0,26,16,26,26,16,0,edgeCount
55,197,243,graphml/Cogentco.graphml,2,2,random,-1,8,7,4,4,4,4,0,4,4,0,4,edgeCount
54,197,243,graphml/Cogentco.graphml,1,0,random,-1,17,17,17,0,4,17,0,17,17,0,4,edgeCount
53,197,243,graphml/Cogentco.graphml,1,0,random,-1,13,13,13,0,0,13,0,13,13,0,0,edgeCount
52,197,243,graphml/Cogentco.graphml,1,0,random,-1,10,10,10,0,2,10,0,10,10,0,2,edgeCount
51,197,243,graphml/Cogentco.graphml,2,2,random,-1,5,5,5,0,0,5,0,5,5,0,0,edgeCount
50,197,243,graphml/Cogentco.graphml,2,2,random,-1,19,13,13,6,0,13,0,13,13,0,0,edgeCount
49,197,243,graphml/Cogentco.graphml,2,2,random,-1,10,10,10,0,0,10,0,10,10,0,0,edgeCount
48,197,243,graphml/Cogentco.graphml,1,0,random,-1,15,15,15,0,0,15,0,15,15,0,0,edgeCount
47,197,243,graphml/Cogentco.graphml,1,0,random,-1,8,8,8,0,0,8,0,8,8,0,0,edgeCount
46,197,243,graphml/Cogentco.graphml,2,2,random,-1,18,18,14,4,2,18,4,18,18,4,2,edgeCount
45,197,243,graphml/Cogentco.graphml,2,2,random,-1,2,2,2,0,4,2,0,2,2,0,4,edgeCount
44,197,243,graphml/Cogentco.graphml,1,0,random,-1,13,13,13,0,2,13,0,13,13,0,2,edgeCount
43,197,243,graphml/Cogentco.graphml,2,2,random,-1,12,12,6,6,2,12,6,12,12,6,2,edgeCount
42,197,243,graphml/Cogentco.graphml,2,2,random,-1,6,6,6,0,2,6,0,6,6,0,2,edgeCount
41,197,243,graphml/Cogentco.graphml,2,2,random,-1,6,6,6,0,2,6,0,6,6,0,2,edgeCount
40,197,243,graphml/Cogentco.graphml,2,2,random,-1,19,19,18,1,0,22,4,19,19,1,0,edgeCount
39,197,243,graphml/Cogentco.graphml,2,2,random,-1,23,41,18,5,4,41,23,41,41,23,4,edgeCount
38,197,243,graphml/Cogentco.graphml,2,2,random,-1,12,12,12,0,0,12,0,12,12,0,0,edgeCount
37,197,243,graphml/Cogentco.graphml,2,2,random,-1,11,11,11,0,0,11,0,11,11,0,0,edgeCount
36,197,243,graphml/Cogentco.graphml,1,0,random,-1,11,11,11,0,2,11,0,11,11,0,2,edgeCount
35,197,243,graphml/Cogentco.graphml,1,0,random,-1,23,23,23,0,2,23,0,23,23,0,2,edgeCount
34,197,243,graphml/Cogentco.graphml,1,0,random,-1,11,26,11,0,2,11,0,11,26,0,2,edgeCount
33,197,243,graphml/Cogentco.graphml,2,2,random,-1,12,12,12,0,0,12,0,12,12,0,0,edgeCount
32,197,243,graphml/Cogentco.graphml,2,2,random,-1,5,5,5,0,0,5,0,5,5,0,0,edgeCount
31,197,243,graphml/Cogentco.graphml,1,0,random,-1,16,16,16,0,0,16,0,16,16,0,0,edgeCount
30,197,243,graphml/Cogentco.graphml,1,0,random,-1,19,22,19,0,2,19,0,19,22,0,2,edgeCount
29,197,243,graphml/Cogentco.graphml,2,2,random,-1,8,8,8,0,0,8,0,8,8,0,0,edgeCount
28,197,243,graphml/Cogentco.graphml,2,2,random,-1,6,5,5,1,0,6,1,6,5,1,0,edgeCount
27,197,243,graphml/Cogentco.graphml,2,2,random,-1,17,17,8,9,2,13,5,13,13,5,2,edgeCount
26,197,243,graphml/Cogentco.graphml,1,0,random,-1,18,30,18,0,4,18,0,18,30,0,4,edgeCount
25,197,243,graphml/Cogentco.graphml,2,2,random,-1,10,10,10,0,0,10,0,10,10,0,0,edgeCount
24,197,243,graphml/Cogentco.graphml,2,2,random,-1,11,7,7,4,0,7,0,7,7,0,0,edgeCount
23,197,243,graphml/Cogentco.graphml,2,2,random,-1,29,21,13,16,4,13,0,13,13,0,2,edgeCount
22,197,243,graphml/Cogentco.graphml,2,2,random,-1,11,11,11,0,0,11,0,11,11,0,0,edgeCount
21,197,243,graphml/Cogentco.graphml,2,2,random,-1,18,18,15,3,0,18,3,18,18,3,0,edgeCount
20,197,243,graphml/Cogentco.graphml,1,0,random,-1,10,19,10,0,4,10,0,10,19,0,4,edgeCount
19,197,243,graphml/Cogentco.graphml,2,2,random,-1,7,7,7,0,2,7,0,7,7,0,2,edgeCount
18,197,243,graphml/Cogentco.graphml,2,2,random,-1,11,11,11,0,4,12,1,12,11,1,4,edgeCount
17,197,243,graphml/Cogentco.graphml,1,0,random,-1,9,9,9,0,0,9,0,9,9,0,0,edgeCount
16,197,243,graphml/Cogentco.graphml,2,2,random,-1,28,28,25,3,0,28,3,28,28,3,0,edgeCount
15,197,243,graphml/Cogentco.graphml,2,2,random,-1,15,15,15,0,0,15,0,15,15,0,0,edgeCount
14,197,243,graphml/Cogentco.graphml,1,0,random,-1,13,13,13,0,0,13,0,13,13,0,0,edgeCount
13,197,243,graphml/Cogentco.graphml,2,2,random,-1,11,6,6,5,0,6,0,6,6,0,0,edgeCount
12,197,243,graphml/Cogentco.graphml,1,0,random,-1,2,2,2,0,0,2,0,2,2,0,0,edgeCount
11,197,243,graphml/Cogentco.graphml,1,0,random,-1,16,16,16,0,0,16,0,16,16,0,0,edgeCount
10,197,243,graphml/Cogentco.graphml,1,0,random,-1,7,22,7,0,2,7,0,7,22,0,2,edgeCount
9,197,243,graphml/Cogentco.graphml,3,4,random,-1,12,5,5,7,0,5,0,5,5,0,0,edgeCount
8,197,243,graphml/Cogentco.graphml,2,2,random,-1,3,3,3,0,0,3,0,3,3,0,0,edgeCount
7,197,243,graphml/Cogentco.graphml,1,0,random,-1,17,17,17,0,2,17,0,17,17,0,2,edgeCount
6,197,243,graphml/Cogentco.graphml,2,2,random,-1,5,5,5,0,0,5,0,5,5,0,0,edgeCount
5,197,243,graphml/Cogentco.graphml,1,0,random,-1,18,18,18,0,0,18,0,18,18,0,0,edgeCount
4,197,243,graphml/Cogentco.graphml,2,2,random,-1,8,8,8,0,0,8,0,8,8,0,0,edgeCount
3,197,243,graphml/Cogentco.graphml,1,0,random,-1,8,8,8,0,0,8,0,8,8,0,0,edgeCount
2,197,243,graphml/Cogentco.graphml,1,0,random,-1,11,11,11,0,0,11,0,11,11,0,0,edgeCount
1,197,243,graphml/Cogentco.graphml,2,2,random,-1,51,15,13,38,2,13,0,13,13,0,2,edgeCount
