rep,nrNodes,nrEdges,edgeProb,nrPaths,nrFails,failureModel,failurePercent,hopsRanked,hopsUnranked,spLength,stretch_mult,nodeAdditions,hopsPath,stretch_path,hopsRankedOne,hopsUnrankedOne,stretch_one,overallNodeAdditionsOne,treeChoice
1000,50,174,0.15,3,34,random,-1,4,4,2,2,0,2,0,2,2,0,0,edgeCount
999,50,167,0.15,4,50,random,-1,5,5,3,2,32,-1,-4,3,3,0,12,edgeCount
998,50,200,0.15,6,84,random,-1,5,5,4,1,0,-1,-5,-1,-1,-5,0,edgeCount
997,50,177,0.15,7,101,random,-1,8,4,4,4,14,-1,-5,-1,-1,-5,4,edgeCount
996,50,174,0.15,6,84,random,-1,-1,-1,5,-6,0,-1,-6,-1,-1,-6,0,edgeCount
995,50,183,0.15,7,101,random,-1,9,4,3,6,0,3,0,3,3,0,0,edgeCount
994,50,183,0.15,7,101,random,-1,-1,-1,6,-7,0,-1,-7,-1,-1,-7,0,edgeCount
993,50,176,0.15,7,101,random,-1,-1,-1,4,-5,0,-1,-5,-1,-1,-5,0,edgeCount
992,50,187,0.15,4,50,random,-1,4,4,4,0,0,-1,-5,-1,-1,-5,0,edgeCount
991,50,173,0.15,4,50,random,-1,3,5,3,0,0,3,0,3,3,0,0,edgeCount
990,50,174,0.15,6,84,random,-1,13,9,3,10,0,-1,-4,-1,-1,-4,0,edgeCount
989,50,178,0.15,6,84,random,-1,6,2,2,4,36,2,0,4,2,2,10,edgeCount
988,50,190,0.15,5,67,random,-1,4,4,2,2,0,2,0,2,2,0,0,edgeCount
987,50,184,0.15,6,84,random,-1,9,11,3,6,16,3,0,3,3,0,4,edgeCount
986,50,194,0.15,9,134,random,-1,-1,-1,3,-4,0,-1,-4,-1,-1,-4,0,edgeCount
985,50,207,0.15,6,84,random,-1,3,2,2,1,0,2,0,3,2,1,0,edgeCount
984,50,194,0.15,7,101,random,-1,7,3,3,4,0,3,0,3,3,0,0,edgeCount
983,50,188,0.15,6,84,random,-1,10,10,2,8,18,2,0,6,2,4,6,edgeCount
982,50,178,0.15,6,84,random,-1,6,5,4,2,18,12,8,12,6,8,6,edgeCount
981,50,179,0.15,3,34,random,-1,4,4,4,0,0,6,2,6,6,2,0,edgeCount
980,50,171,0.15,5,67,random,-1,4,4,3,1,8,4,1,4,4,1,2,edgeCount
979,50,166,0.15,6,84,random,-1,5,16,3,2,0,9,6,9,9,6,0,edgeCount
978,50,182,0.15,2,17,random,-1,4,4,2,2,0,2,0,4,2,2,0,edgeCount
977,50,209,0.15,9,134,random,-1,-1,-1,3,-4,0,-1,-4,-1,-1,-4,0,edgeCount
976,50,176,0.15,5,67,random,-1,5,5,3,2,0,3,0,3,3,0,0,edgeCount
975,50,172,0.15,6,84,random,-1,4,4,2,2,6,4,2,4,4,2,2,edgeCount
974,50,198,0.15,9,134,random,-1,-1,-1,-1,0,0,-1,0,-1,-1,0,0,edgeCount
973,50,188,0.15,6,84,random,-1,18,10,4,14,0,-1,-5,-1,-1,-5,0,edgeCount
972,50,196,0.15,3,34,random,-1,3,9,3,0,42,3,0,3,5,0,14,edgeCount
971,50,174,0.15,6,84,random,-1,23,21,5,18,54,-1,-6,-1,-1,-6,16,edgeCount
970,50,182,0.15,3,34,random,-1,3,4,3,0,0,3,0,3,3,0,0,edgeCount
969,50,187,0.15,4,50,random,-1,6,8,3,3,0,8,5,8,8,5,0,edgeCount
968,50,161,0.15,3,34,random,-1,2,5,2,0,18,2,0,2,2,0,6,edgeCount
967,50,178,0.15,7,101,random,-1,4,2,2,2,8,2,0,2,2,0,2,edgeCount
966,50,183,0.15,5,67,random,-1,3,4,2,1,8,4,2,7,4,5,2,edgeCount
965,50,188,0.15,5,67,random,-1,3,9,3,0,0,5,2,3,3,0,0,edgeCount
964,50,183,0.15,5,67,random,-1,7,3,3,4,6,5,2,3,5,0,2,edgeCount
963,50,189,0.15,7,101,random,-1,8,6,4,4,0,-1,-5,-1,-1,-5,0,edgeCount
962,50,196,0.15,7,101,random,-1,-1,-1,5,-6,8,-1,-6,-1,-1,-6,2,edgeCount
961,50,192,0.15,6,84,random,-1,3,8,3,0,0,3,0,5,5,2,0,edgeCount
960,50,183,0.15,4,50,random,-1,5,5,4,1,14,6,2,6,6,2,4,edgeCount
959,50,193,0.15,7,101,random,-1,10,2,2,8,14,2,0,6,2,4,4,edgeCount
958,50,199,0.15,6,84,random,-1,7,13,3,4,12,9,6,3,5,0,4,edgeCount
957,50,201,0.15,2,17,random,-1,3,6,3,0,20,3,0,3,3,0,10,edgeCount
956,50,187,0.15,4,50,random,-1,5,6,3,2,0,7,4,7,7,4,0,edgeCount
955,50,178,0.15,7,101,random,-1,3,4,2,1,10,2,0,3,2,1,4,edgeCount
954,50,183,0.15,10,151,random,-1,-1,-1,3,-4,0,-1,-4,-1,-1,-4,0,edgeCount
953,50,181,0.15,4,50,random,-1,8,3,3,5,38,3,0,3,3,0,10,edgeCount
952,50,174,0.15,6,84,random,-1,9,7,3,6,0,9,6,9,9,6,0,edgeCount
951,50,198,0.15,4,50,random,-1,12,6,4,8,44,-1,-5,8,4,4,12,edgeCount
950,50,180,0.15,5,67,random,-1,7,9,3,4,6,-1,-4,-1,-1,-4,2,edgeCount
949,50,175,0.15,3,34,random,-1,3,13,3,0,0,7,4,7,7,4,0,edgeCount
948,50,171,0.15,7,101,random,-1,8,4,4,4,8,-1,-5,-1,-1,-5,2,edgeCount
947,50,167,0.15,4,50,random,-1,8,2,2,6,0,2,0,2,2,0,0,edgeCount
946,50,184,0.15,5,67,random,-1,4,4,4,0,0,8,4,8,8,4,0,edgeCount
945,50,195,0.15,9,134,random,-1,14,16,2,12,2,4,2,4,4,2,2,edgeCount
944,50,205,0.15,3,34,random,-1,3,2,2,1,36,2,0,2,2,0,12,edgeCount
943,50,163,0.15,3,34,random,-1,3,9,3,0,0,3,0,3,3,0,0,edgeCount
942,50,185,0.15,4,50,random,-1,-1,-1,4,-5,0,-1,-5,-1,-1,-5,0,edgeCount
941,50,177,0.15,5,67,random,-1,3,8,3,0,30,3,0,3,3,0,8,edgeCount
940,50,194,0.15,9,134,random,-1,5,5,3,2,20,7,4,7,7,4,6,edgeCount
939,50,184,0.15,6,84,random,-1,13,5,3,10,24,7,4,5,7,2,6,edgeCount
938,50,199,0.15,7,101,random,-1,4,3,3,1,10,3,0,3,3,0,2,edgeCount
937,50,195,0.15,7,101,random,-1,3,4,2,1,0,2,0,3,2,1,0,edgeCount
936,50,174,0.15,4,50,random,-1,4,2,2,2,0,2,0,4,2,2,0,edgeCount
935,50,177,0.15,8,118,random,-1,-1,-1,6,-7,0,-1,-7,-1,-1,-7,0,edgeCount
934,50,176,0.15,7,101,random,-1,-1,-1,4,-5,16,-1,-5,-1,-1,-5,4,edgeCount
933,50,201,0.15,5,67,random,-1,20,10,2,18,0,2,0,2,2,0,0,edgeCount
932,50,182,0.15,7,101,random,-1,8,2,2,6,26,2,0,4,2,2,8,edgeCount
931,50,191,0.15,3,34,random,-1,4,4,4,0,0,4,0,4,4,0,0,edgeCount
930,50,193,0.15,6,84,random,-1,3,5,3,0,0,3,0,3,3,0,0,edgeCount
929,50,176,0.15,6,84,random,-1,3,7,3,0,0,7,4,3,3,0,0,edgeCount
928,50,204,0.15,7,101,random,-1,12,25,4,8,44,-1,-5,14,4,10,12,edgeCount
927,50,193,0.15,4,50,random,-1,4,6,3,1,0,8,5,8,8,5,0,edgeCount
926,50,185,0.15,5,67,random,-1,9,3,3,6,0,3,0,3,3,0,0,edgeCount
925,50,192,0.15,9,134,random,-1,-1,-1,6,-7,0,-1,-7,-1,-1,-7,0,edgeCount
924,50,163,0.15,3,34,random,-1,3,3,3,0,0,3,0,3,3,0,0,edgeCount
923,50,165,0.15,6,84,random,-1,17,5,3,14,2,-1,-4,-1,-1,-4,2,edgeCount
922,50,194,0.15,6,84,random,-1,4,6,3,1,14,12,9,12,12,9,4,edgeCount
921,50,173,0.15,7,101,random,-1,-1,-1,5,-6,0,-1,-6,-1,-1,-6,0,edgeCount
920,50,201,0.15,11,168,random,-1,-1,-1,-1,0,0,-1,0,-1,-1,0,0,edgeCount
919,50,174,0.15,7,101,random,-1,3,15,3,0,0,7,4,3,3,0,0,edgeCount
918,50,161,0.15,5,67,random,-1,10,7,3,7,0,5,2,5,5,2,0,edgeCount
917,50,179,0.15,7,101,random,-1,6,4,2,4,0,2,0,4,2,2,0,edgeCount
916,50,198,0.15,7,101,random,-1,10,8,2,8,0,2,0,4,2,2,0,edgeCount
915,50,185,0.15,8,118,random,-1,-1,-1,4,-5,0,-1,-5,-1,-1,-5,0,edgeCount
914,50,183,0.15,8,118,random,-1,10,8,4,6,0,-1,-5,-1,-1,-5,0,edgeCount
913,50,197,0.15,7,101,random,-1,3,6,3,0,50,5,2,5,5,2,12,edgeCount
912,50,181,0.15,5,67,random,-1,6,17,4,2,16,-1,-5,-1,-1,-5,4,edgeCount
911,50,200,0.15,6,84,random,-1,7,8,3,4,0,3,0,3,3,0,0,edgeCount
910,50,184,0.15,9,134,random,-1,-1,-1,4,-5,0,-1,-5,-1,-1,-5,0,edgeCount
909,50,156,0.15,3,34,random,-1,3,4,3,0,0,3,0,3,3,0,0,edgeCount
908,50,182,0.15,4,50,random,-1,4,4,4,0,0,-1,-5,-1,-1,-5,0,edgeCount
907,50,177,0.15,7,101,random,-1,7,3,3,4,28,3,0,7,7,4,8,edgeCount
906,50,179,0.15,6,84,random,-1,4,12,2,2,30,2,0,6,2,4,8,edgeCount
905,50,179,0.15,5,67,random,-1,35,2,2,33,0,4,2,6,4,4,0,edgeCount
904,50,153,0.15,5,67,random,-1,6,4,2,4,6,2,0,4,2,2,2,edgeCount
903,50,178,0.15,5,67,random,-1,6,4,3,3,0,6,3,6,6,3,0,edgeCount
902,50,190,0.15,6,84,random,-1,8,3,2,6,0,2,0,2,2,0,0,edgeCount
901,50,195,0.15,5,67,random,-1,4,5,4,0,16,8,4,8,8,4,4,edgeCount
900,50,198,0.15,4,50,random,-1,8,2,2,6,40,2,0,3,2,1,10,edgeCount
899,50,180,0.15,9,134,random,-1,-1,-1,4,-5,0,-1,-5,-1,-1,-5,0,edgeCount
898,50,170,0.15,6,84,random,-1,-1,-1,-1,0,0,-1,0,-1,-1,0,0,edgeCount
897,50,186,0.15,6,84,random,-1,3,3,3,0,0,6,3,8,8,5,0,edgeCount
896,50,190,0.15,5,67,random,-1,3,6,3,0,54,7,4,3,3,0,18,edgeCount
895,50,192,0.15,3,34,random,-1,3,2,2,1,50,2,0,2,2,0,18,edgeCount
894,50,193,0.15,4,50,random,-1,3,10,3,0,16,5,2,5,5,2,4,edgeCount
893,50,188,0.15,6,84,random,-1,-1,-1,4,-5,0,-1,-5,-1,-1,-5,0,edgeCount
892,50,178,0.15,6,84,random,-1,4,14,4,0,0,12,8,10,10,6,0,edgeCount
891,50,165,0.15,3,34,random,-1,15,7,3,12,0,5,2,3,3,0,0,edgeCount
890,50,202,0.15,7,101,random,-1,7,11,4,3,0,-1,-5,-1,-1,-5,0,edgeCount
889,50,159,0.15,1,0,random,-1,3,5,3,0,10,3,0,3,5,0,10,edgeCount
888,50,160,0.15,8,118,random,-1,-1,-1,-1,0,38,-1,0,-1,-1,0,14,edgeCount
887,50,189,0.15,10,151,random,-1,5,7,3,2,0,7,4,5,7,2,0,edgeCount
886,50,179,0.15,7,101,random,-1,4,2,2,2,0,2,0,2,2,0,0,edgeCount
885,50,190,0.15,9,134,random,-1,-1,-1,5,-6,0,-1,-6,-1,-1,-6,0,edgeCount
884,50,159,0.15,7,101,random,-1,3,3,3,0,0,3,0,3,3,0,0,edgeCount
883,50,190,0.15,5,67,random,-1,5,3,3,2,0,3,0,3,3,0,0,edgeCount
882,50,179,0.15,6,84,random,-1,3,3,2,1,0,2,0,2,2,0,0,edgeCount
881,50,193,0.15,2,17,random,-1,2,5,2,0,40,2,0,2,2,0,20,edgeCount
880,50,169,0.15,7,101,random,-1,-1,-1,4,-5,0,-1,-5,-1,-1,-5,0,edgeCount
879,50,183,0.15,5,67,random,-1,16,3,2,14,0,2,0,3,2,1,0,edgeCount
878,50,191,0.15,7,101,random,-1,24,14,2,22,0,2,0,2,2,0,0,edgeCount
877,50,188,0.15,6,84,random,-1,-1,-1,4,-5,0,-1,-5,-1,-1,-5,0,edgeCount
876,50,177,0.15,4,50,random,-1,4,4,3,1,40,6,3,6,9,3,10,edgeCount
875,50,183,0.15,8,118,random,-1,9,3,3,6,6,3,0,3,3,0,2,edgeCount
874,50,161,0.15,1,0,random,-1,3,5,3,0,10,3,0,3,5,0,10,edgeCount
873,50,171,0.15,4,50,random,-1,6,5,3,3,18,3,0,3,3,0,6,edgeCount
872,50,181,0.15,3,34,random,-1,3,3,2,1,36,2,0,3,2,1,12,edgeCount
871,50,184,0.15,7,101,random,-1,-1,-1,5,-6,0,-1,-6,-1,-1,-6,0,edgeCount
870,50,174,0.15,6,84,random,-1,25,9,4,21,14,-1,-5,-1,-1,-5,4,edgeCount
869,50,170,0.15,7,101,random,-1,3,2,2,1,0,2,0,2,2,0,0,edgeCount
868,50,173,0.15,7,101,random,-1,8,2,2,6,34,2,0,2,2,0,10,edgeCount
867,50,190,0.15,8,118,random,-1,8,4,4,4,0,-1,-5,-1,-1,-5,0,edgeCount
866,50,178,0.15,7,101,random,-1,12,2,2,10,0,2,0,2,2,0,0,edgeCount
865,50,189,0.15,6,84,random,-1,-1,-1,5,-6,0,-1,-6,-1,-1,-6,0,edgeCount
864,50,165,0.15,5,67,random,-1,4,4,3,1,26,3,0,3,3,0,10,edgeCount
863,50,189,0.15,3,34,random,-1,5,4,3,2,36,3,0,3,3,0,12,edgeCount
862,50,204,0.15,4,50,random,-1,3,4,3,0,16,3,0,3,3,0,4,edgeCount
861,50,189,0.15,5,67,random,-1,4,10,3,1,0,6,3,6,6,3,0,edgeCount
860,50,185,0.15,6,84,random,-1,12,12,4,8,8,-1,-5,-1,-1,-5,2,edgeCount
859,50,177,0.15,5,67,random,-1,3,8,3,0,0,9,6,7,7,4,0,edgeCount
858,50,208,0.15,6,84,random,-1,3,3,3,0,44,3,0,3,3,0,10,edgeCount
857,50,168,0.15,6,84,random,-1,14,6,4,10,4,-1,-5,-1,-1,-5,2,edgeCount
856,50,182,0.15,6,84,random,-1,15,2,2,13,28,2,0,2,2,0,8,edgeCount
855,50,176,0.15,5,67,random,-1,3,2,2,1,44,2,0,3,2,1,12,edgeCount
854,50,200,0.15,9,134,random,-1,9,3,3,6,30,3,0,3,3,0,8,edgeCount
853,50,179,0.15,9,134,random,-1,-1,-1,-1,0,0,-1,0,-1,-1,0,0,edgeCount
852,50,190,0.15,1,0,random,-1,4,5,4,0,6,4,0,4,5,0,6,edgeCount
851,50,187,0.15,6,84,random,-1,6,4,4,2,0,-1,-5,-1,-1,-5,0,edgeCount
850,50,177,0.15,6,84,random,-1,4,4,2,2,12,2,0,4,2,2,4,edgeCount
849,50,193,0.15,8,118,random,-1,10,13,3,7,16,7,4,3,7,0,4,edgeCount
848,50,187,0.15,5,67,random,-1,8,4,2,6,0,4,2,4,4,2,0,edgeCount
847,50,171,0.15,7,101,random,-1,3,13,3,0,0,7,4,3,3,0,0,edgeCount
846,50,185,0.15,8,118,random,-1,-1,-1,6,-7,0,-1,-7,-1,-1,-7,0,edgeCount
845,50,185,0.15,5,67,random,-1,-1,-1,4,-5,20,-1,-5,-1,-1,-5,6,edgeCount
844,50,182,0.15,10,151,random,-1,-1,-1,3,-4,0,-1,-4,-1,-1,-4,0,edgeCount
843,50,191,0.15,7,101,random,-1,15,5,4,11,0,-1,-5,-1,-1,-5,0,edgeCount
842,50,185,0.15,4,50,random,-1,2,12,2,0,0,2,0,6,2,4,0,edgeCount
841,50,170,0.15,7,101,random,-1,3,14,2,1,0,2,0,3,2,1,0,edgeCount
840,50,172,0.15,7,101,random,-1,-1,-1,4,-5,10,-1,-5,-1,-1,-5,4,edgeCount
839,50,205,0.15,6,84,random,-1,5,4,2,3,30,4,2,6,4,4,8,edgeCount
838,50,190,0.15,5,67,random,-1,7,6,4,3,0,9,5,9,9,5,0,edgeCount
837,50,194,0.15,7,101,random,-1,18,10,4,14,26,-1,-5,-1,-1,-5,8,edgeCount
836,50,207,0.15,8,118,random,-1,-1,-1,5,-6,0,-1,-6,-1,-1,-6,0,edgeCount
835,50,178,0.15,4,50,random,-1,4,7,3,1,0,3,0,3,3,0,0,edgeCount
834,50,187,0.15,5,67,random,-1,12,4,3,9,0,-1,-4,-1,-1,-4,0,edgeCount
833,50,195,0.15,10,151,random,-1,-1,-1,4,-5,0,-1,-5,-1,-1,-5,0,edgeCount
832,50,176,0.15,7,101,random,-1,-1,-1,5,-6,0,-1,-6,-1,-1,-6,0,edgeCount
831,50,185,0.15,7,101,random,-1,-1,-1,4,-5,0,-1,-5,-1,-1,-5,0,edgeCount
830,50,177,0.15,7,101,random,-1,6,2,2,4,4,2,0,4,2,2,2,edgeCount
829,50,169,0.15,2,17,random,-1,2,2,2,0,0,2,0,2,2,0,0,edgeCount
828,50,182,0.15,8,118,random,-1,8,2,2,6,0,2,0,12,2,10,0,edgeCount
827,50,191,0.15,6,84,random,-1,9,5,3,6,0,3,0,3,3,0,0,edgeCount
826,50,192,0.15,4,50,random,-1,5,3,3,2,16,3,0,3,3,0,6,edgeCount
825,50,164,0.15,5,67,random,-1,3,7,3,0,0,3,0,3,3,0,0,edgeCount
824,50,187,0.15,6,84,random,-1,-1,-1,5,-6,16,-1,-6,-1,-1,-6,4,edgeCount
823,50,175,0.15,3,34,random,-1,4,5,2,2,0,2,0,4,2,2,0,edgeCount
822,50,184,0.15,6,84,random,-1,7,4,3,4,0,3,0,3,3,0,0,edgeCount
821,50,190,0.15,5,67,random,-1,8,6,4,4,20,-1,-5,-1,-1,-5,6,edgeCount
820,50,173,0.15,3,34,random,-1,3,4,3,0,6,3,0,3,3,0,2,edgeCount
819,50,163,0.15,5,67,random,-1,2,2,2,0,24,2,0,2,2,0,8,edgeCount
818,50,181,0.15,5,67,random,-1,17,15,3,14,0,5,2,3,5,0,0,edgeCount
817,50,172,0.15,6,84,random,-1,-1,-1,4,-5,0,-1,-5,-1,-1,-5,0,edgeCount
816,50,183,0.15,3,34,random,-1,3,3,3,0,18,3,0,3,3,0,6,edgeCount
815,50,184,0.15,7,101,random,-1,7,8,3,4,10,5,2,5,5,2,2,edgeCount
814,50,184,0.15,8,118,random,-1,-1,-1,4,-5,12,-1,-5,-1,-1,-5,4,edgeCount
813,50,180,0.15,6,84,random,-1,8,4,4,4,0,-1,-5,-1,-1,-5,0,edgeCount
812,50,174,0.15,5,67,random,-1,5,9,3,2,0,5,2,5,5,2,0,edgeCount
811,50,164,0.15,7,101,random,-1,3,5,3,0,0,5,2,5,7,2,0,edgeCount
810,50,172,0.15,3,34,random,-1,4,4,4,0,12,6,2,6,6,2,4,edgeCount
809,50,174,0.15,3,34,random,-1,3,11,2,1,42,2,0,2,2,0,16,edgeCount
808,50,184,0.15,5,67,random,-1,2,7,2,0,0,2,0,4,2,2,0,edgeCount
807,50,183,0.15,5,67,random,-1,2,4,2,0,0,2,0,2,2,0,0,edgeCount
806,50,192,0.15,5,67,random,-1,7,3,3,4,8,3,0,3,3,0,2,edgeCount
805,50,169,0.15,5,67,random,-1,4,6,4,0,0,6,2,6,6,2,0,edgeCount
804,50,195,0.15,6,84,random,-1,3,3,3,0,0,9,6,3,5,0,0,edgeCount
803,50,178,0.15,5,67,random,-1,5,2,2,3,34,2,0,3,2,1,12,edgeCount
802,50,197,0.15,6,84,random,-1,9,9,3,6,30,3,0,3,3,0,8,edgeCount
801,50,172,0.15,5,67,random,-1,7,5,3,4,0,3,0,3,3,0,0,edgeCount
800,50,200,0.15,7,101,random,-1,-1,-1,4,-5,0,-1,-5,-1,-1,-5,0,edgeCount
799,50,174,0.15,6,84,random,-1,16,5,3,13,0,5,2,5,5,2,0,edgeCount
798,50,160,0.15,6,84,random,-1,-1,-1,4,-5,0,-1,-5,-1,-1,-5,0,edgeCount
797,50,167,0.15,5,67,random,-1,-1,-1,4,-5,0,-1,-5,-1,-1,-5,0,edgeCount
796,50,168,0.15,3,34,random,-1,4,4,3,1,22,3,0,3,3,0,8,edgeCount
795,50,194,0.15,7,101,random,-1,3,17,3,0,0,7,4,3,5,0,0,edgeCount
794,50,202,0.15,7,101,random,-1,2,2,2,0,0,2,0,2,2,0,0,edgeCount
793,50,174,0.15,5,67,random,-1,5,3,3,2,16,7,4,3,5,0,4,edgeCount
792,50,170,0.15,5,67,random,-1,12,18,2,10,0,2,0,10,2,8,0,edgeCount
791,50,161,0.15,7,101,random,-1,4,4,4,0,10,-1,-5,-1,-1,-5,4,edgeCount
790,50,179,0.15,6,84,random,-1,2,2,2,0,14,2,0,2,2,0,4,edgeCount
789,50,174,0.15,5,67,random,-1,10,4,3,7,16,3,0,3,3,0,4,edgeCount
788,50,176,0.15,6,84,random,-1,4,2,2,2,0,2,0,2,2,0,0,edgeCount
787,50,185,0.15,5,67,random,-1,6,5,4,2,0,-1,-5,-1,-1,-5,0,edgeCount
786,50,198,0.15,7,101,random,-1,5,11,3,2,0,5,2,5,5,2,0,edgeCount
785,50,204,0.15,7,101,random,-1,-1,-1,-1,0,0,-1,0,-1,-1,0,0,edgeCount
784,50,178,0.15,9,134,random,-1,-1,-1,-1,0,10,-1,0,-1,-1,0,4,edgeCount
783,50,171,0.15,5,67,random,-1,15,15,3,12,0,5,2,3,3,0,0,edgeCount
782,50,189,0.15,5,67,random,-1,3,3,3,0,34,3,0,3,3,0,8,edgeCount
781,50,191,0.15,8,118,random,-1,-1,-1,5,-6,0,-1,-6,-1,-1,-6,0,edgeCount
780,50,191,0.15,7,101,random,-1,3,11,3,0,0,-1,-4,-1,-1,-4,0,edgeCount
779,50,197,0.15,7,101,random,-1,5,5,5,0,20,-1,-6,-1,-1,-6,6,edgeCount
778,50,164,0.15,5,67,random,-1,4,8,3,1,0,8,5,8,8,5,0,edgeCount
777,50,162,0.15,9,134,random,-1,-1,-1,3,-4,0,-1,-4,-1,-1,-4,0,edgeCount
776,50,190,0.15,4,50,random,-1,2,2,2,0,32,2,0,2,2,0,8,edgeCount
775,50,168,0.15,7,101,random,-1,-1,-1,4,-5,8,-1,-5,-1,-1,-5,2,edgeCount
774,50,186,0.15,7,101,random,-1,4,4,2,2,24,2,0,4,2,2,8,edgeCount
773,50,190,0.15,9,134,random,-1,8,8,2,6,0,2,0,4,2,2,0,edgeCount
772,50,178,0.15,4,50,random,-1,3,7,3,0,0,3,0,3,3,0,0,edgeCount
771,50,217,0.15,11,168,random,-1,-1,-1,-1,0,0,-1,0,-1,-1,0,0,edgeCount
770,50,178,0.15,5,67,random,-1,6,4,2,4,0,2,0,4,2,2,0,edgeCount
769,50,158,0.15,4,50,random,-1,5,5,2,3,20,2,0,4,2,2,8,edgeCount
768,50,185,0.15,5,67,random,-1,4,8,3,1,40,7,4,5,7,2,10,edgeCount
767,50,208,0.15,7,101,random,-1,4,7,2,2,0,2,0,3,2,1,0,edgeCount
766,50,169,0.15,4,50,random,-1,7,4,4,3,6,4,0,4,4,0,4,edgeCount
765,50,182,0.15,7,101,random,-1,-1,-1,5,-6,38,-1,-6,-1,-1,-6,10,edgeCount
764,50,187,0.15,6,84,random,-1,4,18,4,0,6,10,6,10,10,6,2,edgeCount
763,50,196,0.15,7,101,random,-1,11,15,5,6,0,-1,-6,-1,-1,-6,0,edgeCount
762,50,186,0.15,6,84,random,-1,11,3,3,8,16,7,4,3,3,0,4,edgeCount
761,50,181,0.15,7,101,random,-1,8,8,2,6,38,2,0,6,2,4,10,edgeCount
760,50,184,0.15,6,84,random,-1,-1,-1,-1,0,0,-1,0,-1,-1,0,0,edgeCount
759,50,164,0.15,8,118,random,-1,-1,-1,9,-10,0,-1,-10,-1,-1,-10,0,edgeCount
758,50,174,0.15,5,67,random,-1,28,21,3,25,38,3,0,9,9,6,12,edgeCount
757,50,172,0.15,5,67,random,-1,3,3,3,0,0,3,0,3,3,0,0,edgeCount
756,50,182,0.15,8,118,random,-1,5,3,3,2,0,3,0,3,3,0,0,edgeCount
755,50,170,0.15,8,118,random,-1,-1,-1,-1,0,0,-1,0,-1,-1,0,0,edgeCount
754,50,178,0.15,6,84,random,-1,4,7,3,1,0,3,0,3,3,0,0,edgeCount
753,50,197,0.15,7,101,random,-1,-1,-1,4,-5,0,-1,-5,-1,-1,-5,0,edgeCount
752,50,188,0.15,8,118,random,-1,13,3,3,10,20,3,0,7,7,4,6,edgeCount
751,50,185,0.15,5,67,random,-1,5,2,2,3,0,2,0,3,2,1,0,edgeCount
750,50,159,0.15,1,0,random,-1,3,3,3,0,0,3,0,3,3,0,0,edgeCount
749,50,201,0.15,6,84,random,-1,12,4,2,10,0,2,0,4,2,2,0,edgeCount
748,50,172,0.15,6,84,random,-1,11,25,3,8,0,7,4,7,7,4,0,edgeCount
747,50,163,0.15,5,67,random,-1,3,5,3,0,38,3,0,7,7,4,12,edgeCount
746,50,179,0.15,3,34,random,-1,4,5,2,2,24,2,0,2,2,0,8,edgeCount
745,50,170,0.15,4,50,random,-1,4,6,4,0,0,6,2,6,6,2,0,edgeCount
744,50,181,0.15,6,84,random,-1,5,21,3,2,0,9,6,5,5,2,0,edgeCount
743,50,179,0.15,4,50,random,-1,6,11,3,3,14,3,0,3,4,0,4,edgeCount
742,50,182,0.15,10,151,random,-1,-1,-1,-1,0,0,-1,0,-1,-1,0,0,edgeCount
741,50,172,0.15,7,101,random,-1,11,7,3,8,0,7,4,7,7,4,0,edgeCount
740,50,178,0.15,5,67,random,-1,4,3,3,1,0,3,0,3,3,0,0,edgeCount
739,50,187,0.15,7,101,random,-1,-1,-1,4,-5,0,-1,-5,-1,-1,-5,0,edgeCount
738,50,196,0.15,6,84,random,-1,8,12,2,6,0,2,0,10,2,8,0,edgeCount
737,50,169,0.15,8,118,random,-1,-1,-1,-1,0,10,-1,0,-1,-1,0,4,edgeCount
736,50,165,0.15,5,67,random,-1,7,3,3,4,14,7,4,9,9,6,4,edgeCount
735,50,169,0.15,8,118,random,-1,-1,-1,-1,0,0,-1,0,-1,-1,0,0,edgeCount
734,50,165,0.15,5,67,random,-1,7,5,3,4,16,7,4,7,7,4,4,edgeCount
733,50,188,0.15,5,67,random,-1,2,2,2,0,0,2,0,2,2,0,0,edgeCount
732,50,184,0.15,5,67,random,-1,4,2,2,2,28,2,0,2,2,0,8,edgeCount
731,50,192,0.15,5,67,random,-1,3,3,2,1,0,2,0,2,2,0,0,edgeCount
730,50,177,0.15,6,84,random,-1,-1,-1,4,-5,0,-1,-5,-1,-1,-5,0,edgeCount
729,50,184,0.15,6,84,random,-1,4,12,2,2,0,2,0,6,2,4,0,edgeCount
728,50,200,0.15,8,118,random,-1,-1,-1,5,-6,0,-1,-6,-1,-1,-6,0,edgeCount
727,50,174,0.15,5,67,random,-1,3,5,2,1,16,4,2,3,4,1,4,edgeCount
726,50,178,0.15,6,84,random,-1,12,6,3,9,32,7,4,7,7,4,10,edgeCount
725,50,186,0.15,7,101,random,-1,-1,-1,4,-5,0,-1,-5,-1,-1,-5,0,edgeCount
724,50,207,0.15,6,84,random,-1,18,12,2,16,0,2,0,6,2,4,0,edgeCount
723,50,186,0.15,3,34,random,-1,3,6,3,0,6,3,0,3,5,0,2,edgeCount
722,50,188,0.15,7,101,random,-1,-1,-1,3,-4,0,-1,-4,-1,-1,-4,0,edgeCount
721,50,187,0.15,5,67,random,-1,5,3,3,2,0,3,0,3,3,0,0,edgeCount
720,50,193,0.15,7,101,random,-1,7,5,4,3,0,5,1,5,5,1,0,edgeCount
719,50,193,0.15,8,118,random,-1,14,2,2,12,0,2,0,2,2,0,0,edgeCount
718,50,189,0.15,6,84,random,-1,9,11,3,6,8,-1,-4,10,10,7,2,edgeCount
717,50,169,0.15,7,101,random,-1,3,3,3,0,16,3,0,3,3,0,6,edgeCount
716,50,182,0.15,10,151,random,-1,-1,-1,-1,0,0,-1,0,-1,-1,0,0,edgeCount
715,50,196,0.15,4,50,random,-1,3,4,3,0,24,3,0,3,3,0,6,edgeCount
714,50,192,0.15,8,118,random,-1,-1,-1,4,-5,0,-1,-5,-1,-1,-5,0,edgeCount
713,50,188,0.15,6,84,random,-1,8,20,4,4,0,-1,-5,-1,-1,-5,0,edgeCount
712,50,190,0.15,8,118,random,-1,3,3,3,0,0,5,2,3,5,0,0,edgeCount
711,50,168,0.15,7,101,random,-1,6,2,2,4,0,2,0,6,2,4,0,edgeCount
710,50,183,0.15,7,101,random,-1,2,2,2,0,0,2,0,2,2,0,0,edgeCount
709,50,180,0.15,6,84,random,-1,8,4,4,4,22,-1,-5,-1,-1,-5,6,edgeCount
708,50,208,0.15,5,67,random,-1,5,7,2,3,28,2,0,4,2,2,6,edgeCount
707,50,177,0.15,7,101,random,-1,6,6,2,4,0,2,0,2,2,0,0,edgeCount
706,50,160,0.15,6,84,random,-1,4,8,4,0,0,12,8,8,8,4,0,edgeCount
705,50,177,0.15,3,34,random,-1,3,3,3,0,0,3,0,3,3,0,0,edgeCount
704,50,156,0.15,7,101,random,-1,-1,-1,3,-4,0,-1,-4,-1,-1,-4,0,edgeCount
703,50,205,0.15,9,134,random,-1,-1,-1,-1,0,0,-1,0,-1,-1,0,0,edgeCount
702,50,182,0.15,9,134,random,-1,-1,-1,4,-5,8,-1,-5,-1,-1,-5,2,edgeCount
701,50,176,0.15,4,50,random,-1,6,8,3,3,0,-1,-4,-1,-1,-4,0,edgeCount
700,50,187,0.15,7,101,random,-1,-1,-1,3,-4,0,-1,-4,-1,-1,-4,0,edgeCount
699,50,165,0.15,4,50,random,-1,3,9,3,0,0,3,0,5,5,2,0,edgeCount
698,50,193,0.15,7,101,random,-1,4,4,2,2,0,2,0,4,2,2,0,edgeCount
697,50,169,0.15,9,134,random,-1,-1,-1,7,-8,0,-1,-8,-1,-1,-8,0,edgeCount
696,50,199,0.15,7,101,random,-1,8,4,2,6,0,2,0,4,2,2,0,edgeCount
695,50,164,0.15,4,50,random,-1,3,3,3,0,16,3,0,3,3,0,4,edgeCount
694,50,182,0.15,8,118,random,-1,-1,-1,4,-5,8,-1,-5,-1,-1,-5,2,edgeCount
693,50,172,0.15,8,118,random,-1,-1,-1,4,-5,10,-1,-5,-1,-1,-5,4,edgeCount
692,50,176,0.15,4,50,random,-1,4,4,2,2,64,2,0,3,2,1,18,edgeCount
691,50,185,0.15,5,67,random,-1,3,11,2,1,0,5,3,3,5,1,0,edgeCount
690,50,188,0.15,3,34,random,-1,2,2,2,0,42,2,0,2,2,0,14,edgeCount
689,50,178,0.15,4,50,random,-1,4,5,2,2,44,2,0,7,2,5,14,edgeCount
688,50,206,0.15,7,101,random,-1,6,4,3,3,0,5,2,5,5,2,0,edgeCount
687,50,164,0.15,6,84,random,-1,-1,-1,3,-4,6,-1,-4,6,8,3,4,edgeCount
686,50,180,0.15,6,84,random,-1,-1,-1,4,-5,0,-1,-5,-1,-1,-5,0,edgeCount
685,50,200,0.15,11,168,random,-1,3,11,3,0,0,5,2,5,11,2,0,edgeCount
684,50,162,0.15,5,67,random,-1,4,10,3,1,0,5,2,5,5,2,0,edgeCount
683,50,190,0.15,9,134,random,-1,-1,-1,5,-6,0,-1,-6,-1,-1,-6,0,edgeCount
682,50,176,0.15,6,84,random,-1,9,5,3,6,0,-1,-4,-1,-1,-4,0,edgeCount
681,50,190,0.15,5,67,random,-1,14,8,3,11,42,5,2,5,7,2,12,edgeCount
680,50,177,0.15,5,67,random,-1,3,7,3,0,0,5,2,5,5,2,0,edgeCount
679,50,169,0.15,8,118,random,-1,8,8,4,4,6,14,10,14,20,10,2,edgeCount
678,50,179,0.15,5,67,random,-1,5,4,3,2,0,3,0,3,3,0,0,edgeCount
677,50,174,0.15,5,67,random,-1,-1,-1,4,-5,0,-1,-5,-1,-1,-5,0,edgeCount
676,50,195,0.15,6,84,random,-1,19,15,4,15,8,-1,-5,-1,-1,-5,2,edgeCount
675,50,185,0.15,3,34,random,-1,3,3,3,0,0,3,0,3,3,0,0,edgeCount
674,50,207,0.15,8,118,random,-1,7,3,3,4,0,9,6,7,9,4,0,edgeCount
673,50,175,0.15,4,50,random,-1,3,4,2,1,16,4,2,4,4,2,4,edgeCount
672,50,204,0.15,9,134,random,-1,-1,-1,6,-7,0,-1,-7,-1,-1,-7,0,edgeCount
671,50,183,0.15,3,34,random,-1,16,16,4,12,0,10,6,10,10,6,0,edgeCount
670,50,197,0.15,11,168,random,-1,-1,-1,-1,0,0,-1,0,-1,-1,0,0,edgeCount
669,50,180,0.15,4,50,random,-1,5,11,4,1,0,-1,-5,-1,-1,-5,0,edgeCount
668,50,178,0.15,8,118,random,-1,6,5,3,3,0,8,5,8,8,5,0,edgeCount
667,50,185,0.15,6,84,random,-1,9,3,3,6,22,9,6,3,5,0,8,edgeCount
666,50,187,0.15,3,34,random,-1,3,8,3,0,24,5,2,5,3,2,12,edgeCount
665,50,194,0.15,9,134,random,-1,-1,-1,4,-5,0,-1,-5,-1,-1,-5,0,edgeCount
664,50,202,0.15,4,50,random,-1,3,3,2,1,46,4,2,4,4,2,12,edgeCount
663,50,176,0.15,6,84,random,-1,10,30,4,6,6,12,8,12,12,8,2,edgeCount
662,50,197,0.15,4,50,random,-1,-1,-1,3,-4,0,-1,-4,-1,-1,-4,0,edgeCount
661,50,219,0.15,4,50,random,-1,7,4,3,4,0,7,4,5,7,2,0,edgeCount
660,50,175,0.15,5,67,random,-1,-1,-1,4,-5,0,-1,-5,-1,-1,-5,0,edgeCount
659,50,176,0.15,5,67,random,-1,4,2,2,2,6,2,0,2,2,0,2,edgeCount
658,50,202,0.15,7,101,random,-1,4,5,2,2,0,2,0,2,2,0,0,edgeCount
657,50,176,0.15,3,34,random,-1,2,2,2,0,12,2,0,2,2,0,4,edgeCount
656,50,188,0.15,7,101,random,-1,2,2,2,0,0,2,0,2,2,0,0,edgeCount
655,50,178,0.15,6,84,random,-1,-1,-1,3,-4,4,-1,-4,-1,-1,-4,2,edgeCount
654,50,195,0.15,4,50,random,-1,2,2,2,0,0,2,0,2,2,0,0,edgeCount
653,50,159,0.15,7,101,random,-1,-1,-1,5,-6,0,-1,-6,-1,-1,-6,0,edgeCount
652,50,189,0.15,7,101,random,-1,7,2,2,5,0,2,0,3,2,1,0,edgeCount
651,50,189,0.15,7,101,random,-1,3,9,3,0,0,7,4,7,7,4,0,edgeCount
650,50,199,0.15,5,67,random,-1,3,3,2,1,0,2,0,3,2,1,0,edgeCount
649,50,193,0.15,7,101,random,-1,17,7,3,14,12,-1,-4,-1,-1,-4,4,edgeCount
648,50,179,0.15,6,84,random,-1,6,10,4,2,14,-1,-5,-1,-1,-5,4,edgeCount
647,50,173,0.15,5,67,random,-1,4,3,3,1,24,3,0,3,3,0,6,edgeCount
646,50,192,0.15,11,168,random,-1,-1,-1,-1,0,8,-1,0,-1,-1,0,2,edgeCount
645,50,190,0.15,9,134,random,-1,5,5,3,2,18,-1,-4,-1,-1,-4,4,edgeCount
644,50,183,0.15,2,17,random,-1,3,3,3,0,0,3,0,3,3,0,0,edgeCount
643,50,157,0.15,3,34,random,-1,3,4,3,0,0,3,0,3,3,0,0,edgeCount
642,50,156,0.15,4,50,random,-1,-1,-1,4,-5,0,-1,-5,-1,-1,-5,0,edgeCount
641,50,204,0.15,9,134,random,-1,11,5,3,8,8,-1,-4,-1,-1,-4,2,edgeCount
640,50,170,0.15,4,50,random,-1,3,7,2,1,0,2,0,3,2,1,0,edgeCount
639,50,175,0.15,4,50,random,-1,6,5,4,2,36,10,6,10,14,6,12,edgeCount
638,50,169,0.15,7,101,random,-1,3,2,2,1,10,2,0,5,2,3,6,edgeCount
637,50,196,0.15,6,84,random,-1,9,3,3,6,0,3,0,3,3,0,0,edgeCount
636,50,187,0.15,6,84,random,-1,6,4,3,3,8,7,4,7,7,4,2,edgeCount
635,50,184,0.15,4,50,random,-1,4,3,2,2,54,2,0,3,2,1,18,edgeCount
634,50,168,0.15,4,50,random,-1,3,4,2,1,28,2,0,3,2,1,10,edgeCount
633,50,184,0.15,1,0,random,-1,3,3,3,0,20,3,0,3,3,0,20,edgeCount
632,50,174,0.15,4,50,random,-1,2,3,2,0,0,2,0,3,2,1,0,edgeCount
631,50,218,0.15,8,118,random,-1,-1,-1,4,-5,0,-1,-5,-1,-1,-5,0,edgeCount
630,50,186,0.15,6,84,random,-1,-1,-1,4,-5,0,-1,-5,-1,-1,-5,0,edgeCount
629,50,184,0.15,7,101,random,-1,-1,-1,4,-5,0,-1,-5,-1,-1,-5,0,edgeCount
628,50,174,0.15,6,84,random,-1,-1,-1,4,-5,0,-1,-5,-1,-1,-5,0,edgeCount
627,50,186,0.15,6,84,random,-1,5,9,3,2,0,3,0,3,3,0,0,edgeCount
626,50,181,0.15,4,50,random,-1,4,8,2,2,26,2,0,4,2,2,8,edgeCount
625,50,170,0.15,8,118,random,-1,-1,-1,5,-6,0,-1,-6,-1,-1,-6,0,edgeCount
624,50,187,0.15,9,134,random,-1,-1,-1,6,-7,0,-1,-7,-1,-1,-7,0,edgeCount
623,50,176,0.15,6,84,random,-1,4,2,2,2,0,2,0,6,2,4,0,edgeCount
622,50,188,0.15,4,50,random,-1,2,5,2,0,22,2,0,3,2,1,6,edgeCount
621,50,218,0.15,11,168,random,-1,-1,-1,6,-7,0,-1,-7,-1,-1,-7,0,edgeCount
620,50,176,0.15,8,118,random,-1,3,9,3,0,6,5,2,3,5,0,2,edgeCount
619,50,177,0.15,5,67,random,-1,2,8,2,0,8,2,0,2,2,0,2,edgeCount
618,50,184,0.15,3,34,random,-1,3,5,3,0,24,3,0,3,3,0,8,edgeCount
617,50,193,0.15,4,50,random,-1,3,5,3,0,32,3,0,3,3,0,8,edgeCount
616,50,214,0.15,11,168,random,-1,-1,-1,-1,0,0,-1,0,-1,-1,0,0,edgeCount
615,50,177,0.15,6,84,random,-1,-1,-1,4,-5,0,-1,-5,-1,-1,-5,0,edgeCount
614,50,193,0.15,5,67,random,-1,2,6,2,0,0,2,0,2,2,0,0,edgeCount
613,50,177,0.15,9,134,random,-1,-1,-1,-1,0,0,-1,0,-1,-1,0,0,edgeCount
612,50,198,0.15,4,50,random,-1,3,3,3,0,66,3,0,3,3,0,18,edgeCount
611,50,199,0.15,7,101,random,-1,3,11,3,0,66,7,4,3,7,0,18,edgeCount
610,50,177,0.15,5,67,random,-1,7,7,3,4,0,3,0,3,3,0,0,edgeCount
609,50,178,0.15,7,101,random,-1,-1,-1,5,-6,0,-1,-6,-1,-1,-6,0,edgeCount
608,50,192,0.15,8,118,random,-1,7,3,3,4,0,5,2,5,9,2,0,edgeCount
607,50,193,0.15,12,185,random,-1,-1,-1,-1,0,0,-1,0,-1,-1,0,0,edgeCount
606,50,184,0.15,7,101,random,-1,10,4,4,6,0,-1,-5,-1,-1,-5,0,edgeCount
605,50,162,0.15,7,101,random,-1,-1,-1,6,-7,0,-1,-7,-1,-1,-7,0,edgeCount
604,50,175,0.15,6,84,random,-1,4,8,2,2,8,2,0,8,2,6,4,edgeCount
603,50,205,0.15,5,67,random,-1,3,4,2,1,0,2,0,4,2,2,0,edgeCount
602,50,180,0.15,8,118,random,-1,3,3,3,0,0,5,2,3,3,0,0,edgeCount
601,50,214,0.15,5,67,random,-1,3,5,2,1,18,2,0,2,2,0,4,edgeCount
600,50,182,0.15,5,67,random,-1,3,11,2,1,0,2,0,3,2,1,0,edgeCount
599,50,193,0.15,9,134,random,-1,-1,-1,5,-6,0,-1,-6,-1,-1,-6,0,edgeCount
598,50,192,0.15,2,17,random,-1,3,4,3,0,20,3,0,3,3,0,10,edgeCount
597,50,189,0.15,5,67,random,-1,-1,-1,3,-4,0,-1,-4,-1,-1,-4,0,edgeCount
596,50,175,0.15,7,101,random,-1,-1,-1,4,-5,6,-1,-5,-1,-1,-5,2,edgeCount
595,50,173,0.15,3,34,random,-1,3,7,2,1,0,2,0,3,2,1,0,edgeCount
594,50,203,0.15,6,84,random,-1,5,9,3,2,0,3,0,3,3,0,0,edgeCount
593,50,190,0.15,7,101,random,-1,3,2,2,1,32,2,0,2,2,0,8,edgeCount
592,50,166,0.15,5,67,random,-1,4,6,4,0,0,-1,-5,-1,-1,-5,0,edgeCount
591,50,187,0.15,5,67,random,-1,8,2,2,6,0,2,0,2,2,0,0,edgeCount
590,50,177,0.15,5,67,random,-1,3,2,2,1,22,2,0,3,2,1,6,edgeCount
589,50,173,0.15,5,67,random,-1,9,3,3,6,0,-1,-4,-1,-1,-4,0,edgeCount
588,50,159,0.15,2,17,random,-1,3,3,3,0,0,3,0,3,3,0,0,edgeCount
587,50,163,0.15,3,34,random,-1,2,3,2,0,0,2,0,3,2,1,0,edgeCount
586,50,196,0.15,3,34,random,-1,2,3,2,0,24,2,0,2,2,0,8,edgeCount
585,50,174,0.15,9,134,random,-1,-1,-1,5,-6,0,-1,-6,-1,-1,-6,0,edgeCount
584,50,175,0.15,8,118,random,-1,-1,-1,-1,0,0,-1,0,-1,-1,0,0,edgeCount
583,50,198,0.15,8,118,random,-1,-1,-1,4,-5,0,-1,-5,-1,-1,-5,0,edgeCount
582,50,196,0.15,6,84,random,-1,4,3,2,2,0,2,0,2,2,0,0,edgeCount
581,50,190,0.15,6,84,random,-1,9,3,3,6,0,5,2,3,5,0,0,edgeCount
580,50,212,0.15,5,67,random,-1,11,9,3,8,0,3,0,7,7,4,0,edgeCount
579,50,194,0.15,5,67,random,-1,6,4,2,4,0,2,0,6,2,4,0,edgeCount
578,50,183,0.15,7,101,random,-1,3,2,2,1,0,2,0,7,2,5,0,edgeCount
577,50,192,0.15,7,101,random,-1,11,9,3,8,34,-1,-4,-1,-1,-4,10,edgeCount
576,50,189,0.15,6,84,random,-1,11,5,3,8,0,-1,-4,-1,-1,-4,0,edgeCount
575,50,185,0.15,4,50,random,-1,3,3,3,0,34,3,0,3,3,0,10,edgeCount
574,50,173,0.15,3,34,random,-1,3,4,3,0,12,3,0,3,3,0,4,edgeCount
573,50,177,0.15,10,151,random,-1,-1,-1,-1,0,8,-1,0,-1,-1,0,2,edgeCount
572,50,210,0.15,8,118,random,-1,-1,-1,3,-4,0,-1,-4,-1,-1,-4,0,edgeCount
571,50,186,0.15,4,50,random,-1,8,5,4,4,30,-1,-5,-1,-1,-5,8,edgeCount
570,50,195,0.15,7,101,random,-1,-1,-1,4,-5,0,-1,-5,-1,-1,-5,0,edgeCount
569,50,174,0.15,5,67,random,-1,-1,-1,3,-4,32,-1,-4,-1,-1,-4,10,edgeCount
568,50,181,0.15,7,101,random,-1,-1,-1,5,-6,6,-1,-6,-1,-1,-6,2,edgeCount
567,50,190,0.15,6,84,random,-1,7,3,3,4,0,3,0,3,5,0,0,edgeCount
566,50,186,0.15,3,34,random,-1,2,5,2,0,12,2,0,2,2,0,4,edgeCount
565,50,198,0.15,10,151,random,-1,-1,-1,5,-6,32,-1,-6,-1,-1,-6,8,edgeCount
564,50,172,0.15,5,67,random,-1,5,3,3,2,0,3,0,3,3,0,0,edgeCount
563,50,187,0.15,9,134,random,-1,-1,-1,-1,0,2,-1,0,-1,-1,0,2,edgeCount
562,50,188,0.15,5,67,random,-1,4,3,2,2,32,2,0,3,2,1,8,edgeCount
561,50,190,0.15,4,50,random,-1,3,12,3,0,16,3,0,3,3,0,4,edgeCount
560,50,182,0.15,6,84,random,-1,13,3,3,10,0,7,4,3,3,0,0,edgeCount
559,50,170,0.15,5,67,random,-1,7,12,3,4,48,-1,-4,12,7,9,14,edgeCount
558,50,178,0.15,7,101,random,-1,3,15,2,1,0,2,0,8,2,6,0,edgeCount
557,50,196,0.15,5,67,random,-1,3,4,3,0,0,5,2,3,3,0,0,edgeCount
556,50,192,0.15,3,34,random,-1,2,3,2,0,0,2,0,3,2,1,0,edgeCount
555,50,176,0.15,6,84,random,-1,3,7,3,0,0,6,3,8,5,5,0,edgeCount
554,50,178,0.15,7,101,random,-1,12,10,2,10,0,2,0,6,2,4,0,edgeCount
553,50,190,0.15,6,84,random,-1,5,17,3,2,14,9,6,9,9,6,4,edgeCount
552,50,206,0.15,9,134,random,-1,6,3,3,3,16,5,2,3,5,0,4,edgeCount
551,50,188,0.15,5,67,random,-1,4,6,3,1,34,5,2,5,5,2,8,edgeCount
550,50,192,0.15,9,134,random,-1,-1,-1,4,-5,18,-1,-5,-1,-1,-5,4,edgeCount
549,50,190,0.15,4,50,random,-1,10,8,3,7,48,9,6,7,11,4,16,edgeCount
548,50,202,0.15,7,101,random,-1,9,5,2,7,14,4,2,5,4,3,4,edgeCount
547,50,208,0.15,5,67,random,-1,3,3,2,1,74,2,0,2,2,0,18,edgeCount
546,50,171,0.15,6,84,random,-1,-1,-1,5,-6,0,-1,-6,-1,-1,-6,0,edgeCount
545,50,184,0.15,4,50,random,-1,3,7,3,0,22,-1,-4,-1,-1,-4,6,edgeCount
544,50,187,0.15,5,67,random,-1,-1,-1,5,-6,8,-1,-6,-1,-1,-6,2,edgeCount
543,50,173,0.15,3,34,random,-1,4,4,4,0,0,4,0,4,4,0,0,edgeCount
542,50,152,0.15,4,50,random,-1,4,3,3,1,6,5,2,3,5,0,2,edgeCount
541,50,180,0.15,8,118,random,-1,-1,-1,6,-7,0,-1,-7,-1,-1,-7,0,edgeCount
540,50,194,0.15,5,67,random,-1,5,2,2,3,38,2,0,3,2,1,12,edgeCount
539,50,193,0.15,5,67,random,-1,3,7,3,0,8,5,2,3,5,0,2,edgeCount
538,50,188,0.15,6,84,random,-1,-1,-1,4,-5,14,-1,-5,-1,-1,-5,6,edgeCount
537,50,189,0.15,5,67,random,-1,4,4,4,0,0,12,8,6,6,2,0,edgeCount
536,50,171,0.15,5,67,random,-1,11,5,4,7,0,-1,-5,-1,-1,-5,0,edgeCount
535,50,193,0.15,6,84,random,-1,-1,-1,4,-5,0,-1,-5,-1,-1,-5,0,edgeCount
534,50,185,0.15,5,67,random,-1,3,6,3,0,0,3,0,3,3,0,0,edgeCount
533,50,159,0.15,7,101,random,-1,8,6,4,4,14,-1,-5,-1,-1,-5,4,edgeCount
532,50,210,0.15,3,34,random,-1,3,3,3,0,0,3,0,3,3,0,0,edgeCount
531,50,184,0.15,6,84,random,-1,10,12,4,6,50,-1,-5,11,11,7,14,edgeCount
530,50,185,0.15,6,84,random,-1,4,4,2,2,0,2,0,4,2,2,0,edgeCount
529,50,197,0.15,4,50,random,-1,4,2,2,2,28,2,0,2,2,0,8,edgeCount
528,50,213,0.15,8,118,random,-1,16,12,3,13,14,-1,-4,-1,-1,-4,4,edgeCount
527,50,199,0.15,5,67,random,-1,5,3,3,2,0,5,2,3,5,0,0,edgeCount
526,50,220,0.15,8,118,random,-1,-1,-1,4,-5,10,-1,-5,-1,-1,-5,2,edgeCount
525,50,190,0.15,8,118,random,-1,-1,-1,4,-5,0,-1,-5,-1,-1,-5,0,edgeCount
524,50,190,0.15,6,84,random,-1,4,12,4,0,0,6,2,6,6,2,0,edgeCount
523,50,181,0.15,9,134,random,-1,-1,-1,4,-5,0,-1,-5,-1,-1,-5,0,edgeCount
522,50,213,0.15,5,67,random,-1,3,15,2,1,0,2,0,6,2,4,0,edgeCount
521,50,184,0.15,7,101,random,-1,-1,-1,4,-5,0,-1,-5,-1,-1,-5,0,edgeCount
520,50,192,0.15,7,101,random,-1,4,5,2,2,32,2,0,6,2,4,8,edgeCount
519,50,192,0.15,3,34,random,-1,4,5,3,1,52,5,2,3,3,0,18,edgeCount
518,50,184,0.15,7,101,random,-1,4,2,2,2,0,2,0,4,2,2,0,edgeCount
517,50,196,0.15,6,84,random,-1,27,27,4,23,16,-1,-5,-1,-1,-5,4,edgeCount
516,50,176,0.15,5,67,random,-1,13,3,3,10,0,3,0,3,3,0,0,edgeCount
515,50,193,0.15,8,118,random,-1,-1,-1,4,-5,0,-1,-5,-1,-1,-5,0,edgeCount
514,50,192,0.15,6,84,random,-1,-1,-1,4,-5,8,-1,-5,-1,-1,-5,2,edgeCount
513,50,171,0.15,7,101,random,-1,-1,-1,5,-6,0,-1,-6,-1,-1,-6,0,edgeCount
512,50,167,0.15,3,34,random,-1,3,4,3,0,0,3,0,3,3,0,0,edgeCount
511,50,166,0.15,6,84,random,-1,-1,-1,-1,0,6,-1,0,-1,-1,0,2,edgeCount
510,50,190,0.15,8,118,random,-1,4,3,2,2,0,2,0,3,2,1,0,edgeCount
509,50,173,0.15,3,34,random,-1,3,11,3,0,0,7,4,7,7,4,0,edgeCount
508,50,174,0.15,8,118,random,-1,-1,-1,5,-6,0,-1,-6,-1,-1,-6,0,edgeCount
507,50,180,0.15,4,50,random,-1,3,4,3,0,52,5,2,5,5,2,14,edgeCount
506,50,173,0.15,8,118,random,-1,-1,-1,5,-6,0,-1,-6,-1,-1,-6,0,edgeCount
505,50,158,0.15,8,118,random,-1,-1,-1,4,-5,0,-1,-5,-1,-1,-5,0,edgeCount
504,50,158,0.15,7,101,random,-1,-1,-1,6,-7,0,-1,-7,-1,-1,-7,0,edgeCount
503,50,183,0.15,9,134,random,-1,-1,-1,4,-5,18,-1,-5,-1,-1,-5,6,edgeCount
502,50,182,0.15,11,168,random,-1,-1,-1,-1,0,0,-1,0,-1,-1,0,0,edgeCount
501,50,181,0.15,5,67,random,-1,4,4,4,0,36,4,0,12,12,8,10,edgeCount
500,50,193,0.15,8,118,random,-1,8,2,2,6,0,2,0,8,2,6,0,edgeCount
499,50,171,0.15,10,151,random,-1,-1,-1,-1,0,4,-1,0,-1,-1,0,2,edgeCount
498,50,181,0.15,5,67,random,-1,3,6,3,0,0,3,0,3,3,0,0,edgeCount
497,50,205,0.15,3,34,random,-1,4,4,2,2,0,2,0,4,2,2,0,edgeCount
496,50,193,0.15,4,50,random,-1,3,3,3,0,0,3,0,3,3,0,0,edgeCount
495,50,175,0.15,4,50,random,-1,7,6,2,5,8,2,0,2,2,0,2,edgeCount
494,50,163,0.15,6,84,random,-1,8,12,2,6,0,2,0,2,2,0,0,edgeCount
493,50,172,0.15,3,34,random,-1,3,3,3,0,12,3,0,3,3,0,4,edgeCount
492,50,209,0.15,7,101,random,-1,-1,-1,4,-5,8,-1,-5,-1,-1,-5,2,edgeCount
491,50,187,0.15,4,50,random,-1,4,7,3,1,0,3,0,3,3,0,0,edgeCount
490,50,190,0.15,7,101,random,-1,10,2,2,8,34,2,0,2,2,0,12,edgeCount
489,50,195,0.15,9,134,random,-1,-1,-1,-1,0,8,-1,0,-1,-1,0,2,edgeCount
488,50,186,0.15,7,101,random,-1,2,10,2,0,0,2,0,10,2,8,0,edgeCount
487,50,178,0.15,9,134,random,-1,-1,-1,7,-8,0,-1,-8,-1,-1,-8,0,edgeCount
486,50,192,0.15,9,134,random,-1,-1,-1,6,-7,10,-1,-7,-1,-1,-7,2,edgeCount
485,50,178,0.15,5,67,random,-1,4,7,3,1,12,3,0,7,7,4,4,edgeCount
484,50,180,0.15,7,101,random,-1,7,2,2,5,38,4,2,8,4,6,12,edgeCount
483,50,193,0.15,3,34,random,-1,3,2,2,1,66,2,0,4,2,2,24,edgeCount
482,50,177,0.15,4,50,random,-1,3,4,3,0,0,3,0,3,3,0,0,edgeCount
481,50,172,0.15,8,118,random,-1,3,3,3,0,6,5,2,3,3,0,2,edgeCount
480,50,191,0.15,9,134,random,-1,-1,-1,5,-6,0,-1,-6,-1,-1,-6,0,edgeCount
479,50,190,0.15,5,67,random,-1,-1,-1,3,-4,0,-1,-4,-1,-1,-4,0,edgeCount
478,50,174,0.15,5,67,random,-1,5,5,2,3,12,2,0,4,2,2,4,edgeCount
477,50,187,0.15,4,50,random,-1,3,4,3,0,0,3,0,3,3,0,0,edgeCount
476,50,166,0.15,4,50,random,-1,5,3,3,2,24,3,0,3,3,0,8,edgeCount
475,50,182,0.15,5,67,random,-1,8,4,2,6,8,2,0,4,2,2,2,edgeCount
474,50,180,0.15,4,50,random,-1,2,2,2,0,38,5,3,3,4,1,10,edgeCount
473,50,201,0.15,6,84,random,-1,5,3,3,2,0,3,0,5,5,2,0,edgeCount
472,50,194,0.15,6,84,random,-1,3,3,3,0,0,5,2,3,3,0,0,edgeCount
471,50,190,0.15,6,84,random,-1,-1,-1,3,-4,24,-1,-4,13,9,10,6,edgeCount
470,50,191,0.15,6,84,random,-1,7,13,2,5,26,2,0,6,2,4,8,edgeCount
469,50,187,0.15,6,84,random,-1,-1,-1,4,-5,0,-1,-5,-1,-1,-5,0,edgeCount
468,50,213,0.15,7,101,random,-1,3,9,3,0,16,11,8,11,11,8,4,edgeCount
467,50,173,0.15,5,67,random,-1,9,4,3,6,0,3,0,5,5,2,0,edgeCount
466,50,200,0.15,6,84,random,-1,5,3,3,2,0,3,0,3,3,0,0,edgeCount
465,50,180,0.15,10,151,random,-1,-1,-1,-1,0,0,-1,0,-1,-1,0,0,edgeCount
464,50,207,0.15,8,118,random,-1,5,5,3,2,14,7,4,7,5,4,4,edgeCount
463,50,174,0.15,7,101,random,-1,4,10,4,0,0,8,4,6,6,2,0,edgeCount
462,50,197,0.15,7,101,random,-1,8,8,3,5,4,12,9,12,4,9,2,edgeCount
461,50,204,0.15,5,67,random,-1,7,3,3,4,0,3,0,3,3,0,0,edgeCount
460,50,186,0.15,8,118,random,-1,3,3,3,0,8,3,0,3,3,0,2,edgeCount
459,50,188,0.15,7,101,random,-1,-1,-1,4,-5,0,-1,-5,-1,-1,-5,0,edgeCount
458,50,193,0.15,6,84,random,-1,-1,-1,4,-5,6,-1,-5,-1,-1,-5,2,edgeCount
457,50,164,0.15,8,118,random,-1,-1,-1,3,-4,18,-1,-4,-1,-1,-4,6,edgeCount
456,50,172,0.15,7,101,random,-1,4,7,3,1,12,3,0,3,3,0,6,edgeCount
455,50,181,0.15,3,34,random,-1,-1,-1,4,-5,6,-1,-5,8,8,4,2,edgeCount
454,50,169,0.15,7,101,random,-1,5,3,3,2,0,7,4,7,7,4,0,edgeCount
453,50,185,0.15,7,101,random,-1,6,6,2,4,0,2,0,2,2,0,0,edgeCount
452,50,178,0.15,5,67,random,-1,6,4,2,4,16,2,0,4,2,2,4,edgeCount
451,50,196,0.15,7,101,random,-1,-1,-1,5,-6,0,-1,-6,-1,-1,-6,0,edgeCount
450,50,181,0.15,7,101,random,-1,7,7,3,4,0,3,0,3,3,0,0,edgeCount
449,50,181,0.15,7,101,random,-1,-1,-1,4,-5,8,-1,-5,-1,-1,-5,2,edgeCount
448,50,211,0.15,8,118,random,-1,3,15,3,0,26,13,10,13,13,10,6,edgeCount
447,50,189,0.15,7,101,random,-1,5,5,3,2,0,3,0,3,3,0,0,edgeCount
446,50,202,0.15,6,84,random,-1,18,14,2,16,8,2,0,4,2,2,2,edgeCount
445,50,191,0.15,3,34,random,-1,3,3,3,0,12,3,0,3,3,0,4,edgeCount
444,50,201,0.15,6,84,random,-1,-1,-1,3,-4,16,-1,-4,-1,-1,-4,6,edgeCount
443,50,197,0.15,8,118,random,-1,10,2,2,8,0,2,0,4,2,2,0,edgeCount
442,50,177,0.15,5,67,random,-1,3,2,2,1,0,2,0,5,2,3,0,edgeCount
441,50,212,0.15,4,50,random,-1,6,5,3,3,24,3,0,3,3,0,8,edgeCount
440,50,199,0.15,5,67,random,-1,-1,-1,3,-4,0,-1,-4,-1,-1,-4,0,edgeCount
439,50,178,0.15,7,101,random,-1,5,5,3,2,28,-1,-4,-1,-1,-4,8,edgeCount
438,50,189,0.15,7,101,random,-1,11,7,3,8,0,5,2,3,5,0,0,edgeCount
437,50,164,0.15,7,101,random,-1,-1,-1,4,-5,12,-1,-5,-1,-1,-5,4,edgeCount
436,50,179,0.15,8,118,random,-1,9,3,3,6,0,-1,-4,-1,-1,-4,0,edgeCount
435,50,180,0.15,4,50,random,-1,3,3,3,0,0,3,0,3,3,0,0,edgeCount
434,50,187,0.15,5,67,random,-1,8,2,2,6,0,2,0,8,2,6,0,edgeCount
433,50,186,0.15,4,50,random,-1,3,3,3,0,0,3,0,3,3,0,0,edgeCount
432,50,169,0.15,4,50,random,-1,3,5,3,0,12,3,0,5,5,2,4,edgeCount
431,50,197,0.15,4,50,random,-1,3,10,3,0,12,-1,-4,15,11,12,4,edgeCount
430,50,167,0.15,4,50,random,-1,4,4,3,1,30,8,5,12,12,9,10,edgeCount
429,50,174,0.15,5,67,random,-1,28,4,4,24,24,-1,-5,-1,-1,-5,6,edgeCount
428,50,183,0.15,4,50,random,-1,3,3,2,1,0,2,0,3,2,1,0,edgeCount
427,50,194,0.15,4,50,random,-1,10,10,3,7,0,8,5,8,8,5,0,edgeCount
426,50,188,0.15,7,101,random,-1,11,9,3,8,0,5,2,3,5,0,0,edgeCount
425,50,178,0.15,6,84,random,-1,17,11,4,13,18,-1,-5,-1,-1,-5,4,edgeCount
424,50,173,0.15,5,67,random,-1,8,4,4,4,42,-1,-5,-1,-1,-5,14,edgeCount
423,50,194,0.15,7,101,random,-1,11,15,3,8,22,3,0,3,3,0,6,edgeCount
422,50,185,0.15,6,84,random,-1,3,3,3,0,0,7,4,3,5,0,0,edgeCount
421,50,193,0.15,7,101,random,-1,17,3,3,14,8,3,0,3,3,0,2,edgeCount
420,50,179,0.15,7,101,random,-1,3,3,3,0,0,7,4,3,7,0,0,edgeCount
419,50,186,0.15,5,67,random,-1,7,3,3,4,38,3,0,3,3,0,10,edgeCount
418,50,189,0.15,5,67,random,-1,6,4,2,4,16,2,0,4,2,2,4,edgeCount
417,50,153,0.15,5,67,random,-1,4,12,4,0,0,8,4,8,8,4,0,edgeCount
416,50,189,0.15,3,34,random,-1,7,9,4,3,24,-1,-5,10,4,6,8,edgeCount
415,50,165,0.15,7,101,random,-1,-1,-1,4,-5,4,-1,-5,-1,-1,-5,2,edgeCount
414,50,188,0.15,4,50,random,-1,3,3,3,0,0,5,2,5,5,2,0,edgeCount
413,50,184,0.15,6,84,random,-1,7,13,3,4,0,7,4,3,7,0,0,edgeCount
412,50,178,0.15,4,50,random,-1,4,6,4,0,26,4,0,4,6,0,8,edgeCount
411,50,185,0.15,5,67,random,-1,3,7,3,0,14,3,0,3,3,0,4,edgeCount
410,50,185,0.15,6,84,random,-1,11,5,2,9,0,2,0,5,2,3,0,edgeCount
409,50,170,0.15,9,134,random,-1,-1,-1,11,-12,0,-1,-12,-1,-1,-12,0,edgeCount
408,50,191,0.15,4,50,random,-1,3,5,2,1,32,2,0,5,2,3,8,edgeCount
407,50,173,0.15,8,118,random,-1,2,2,2,0,0,2,0,2,2,0,0,edgeCount
406,50,159,0.15,4,50,random,-1,5,5,4,1,20,-1,-5,-1,-1,-5,6,edgeCount
405,50,193,0.15,5,67,random,-1,10,3,3,7,6,3,0,3,3,0,2,edgeCount
404,50,171,0.15,4,50,random,-1,6,6,4,2,6,-1,-5,-1,-1,-5,2,edgeCount
403,50,178,0.15,8,118,random,-1,-1,-1,6,-7,30,-1,-7,-1,-1,-7,10,edgeCount
402,50,154,0.15,4,50,random,-1,4,19,3,1,22,14,11,14,10,11,10,edgeCount
401,50,167,0.15,5,67,random,-1,8,4,2,6,0,2,0,4,2,2,0,edgeCount
400,50,174,0.15,6,84,random,-1,4,3,3,1,14,3,0,3,3,0,4,edgeCount
399,50,187,0.15,6,84,random,-1,4,2,2,2,0,2,0,2,2,0,0,edgeCount
398,50,176,0.15,4,50,random,-1,12,16,3,9,26,3,0,3,3,0,10,edgeCount
397,50,194,0.15,9,134,random,-1,6,6,2,4,22,2,0,2,2,0,6,edgeCount
396,50,163,0.15,4,50,random,-1,10,20,2,8,24,2,0,4,2,2,8,edgeCount
395,50,191,0.15,8,118,random,-1,-1,-1,5,-6,0,-1,-6,-1,-1,-6,0,edgeCount
394,50,181,0.15,5,67,random,-1,4,11,4,0,8,10,6,12,12,8,2,edgeCount
393,50,185,0.15,7,101,random,-1,-1,-1,3,-4,0,-1,-4,-1,-1,-4,0,edgeCount
392,50,172,0.15,4,50,random,-1,3,3,2,1,0,2,0,3,2,1,0,edgeCount
391,50,213,0.15,5,67,random,-1,6,2,2,4,18,2,0,4,2,2,6,edgeCount
390,50,186,0.15,5,67,random,-1,9,5,3,6,30,3,0,3,3,0,8,edgeCount
389,50,182,0.15,5,67,random,-1,4,4,3,1,0,3,0,3,3,0,0,edgeCount
388,50,204,0.15,7,101,random,-1,7,5,3,4,54,7,4,7,7,4,12,edgeCount
387,50,181,0.15,4,50,random,-1,9,7,5,4,6,11,6,11,5,6,2,edgeCount
386,50,176,0.15,1,0,random,-1,4,5,4,0,6,4,0,4,5,0,6,edgeCount
385,50,182,0.15,6,84,random,-1,11,3,3,8,16,5,2,5,5,2,4,edgeCount
384,50,173,0.15,7,101,random,-1,8,2,2,6,32,2,0,2,2,0,10,edgeCount
383,50,178,0.15,4,50,random,-1,6,8,4,2,30,8,4,8,8,4,8,edgeCount
382,50,175,0.15,5,67,random,-1,10,8,4,6,36,-1,-5,-1,-1,-5,10,edgeCount
381,50,187,0.15,5,67,random,-1,-1,-1,3,-4,0,-1,-4,-1,-1,-4,0,edgeCount
380,50,176,0.15,9,134,random,-1,6,2,2,4,12,2,0,2,2,0,4,edgeCount
379,50,188,0.15,6,84,random,-1,8,12,3,5,0,-1,-4,-1,-1,-4,0,edgeCount
378,50,202,0.15,7,101,random,-1,-1,-1,-1,0,42,-1,0,-1,-1,0,10,edgeCount
377,50,185,0.15,9,134,random,-1,10,3,3,7,0,5,2,7,9,4,0,edgeCount
376,50,157,0.15,6,84,random,-1,-1,-1,3,-4,4,-1,-4,-1,-1,-4,2,edgeCount
375,50,176,0.15,4,50,random,-1,2,8,2,0,6,2,0,6,2,4,2,edgeCount
374,50,160,0.15,6,84,random,-1,19,17,2,17,0,2,0,8,2,6,0,edgeCount
373,50,170,0.15,3,34,random,-1,2,3,2,0,0,2,0,3,2,1,0,edgeCount
372,50,196,0.15,10,151,random,-1,-1,-1,-1,0,0,-1,0,-1,-1,0,0,edgeCount
371,50,180,0.15,6,84,random,-1,5,3,3,2,0,3,0,3,3,0,0,edgeCount
370,50,190,0.15,8,118,random,-1,-1,-1,3,-4,0,-1,-4,-1,-1,-4,0,edgeCount
369,50,166,0.15,5,67,random,-1,-1,-1,4,-5,0,-1,-5,-1,-1,-5,0,edgeCount
368,50,172,0.15,4,50,random,-1,5,5,5,0,0,-1,-6,-1,-1,-6,0,edgeCount
367,50,177,0.15,8,118,random,-1,-1,-1,6,-7,0,-1,-7,-1,-1,-7,0,edgeCount
366,50,164,0.15,3,34,random,-1,3,3,2,1,12,2,0,3,2,1,4,edgeCount
365,50,182,0.15,8,118,random,-1,-1,-1,4,-5,0,-1,-5,-1,-1,-5,0,edgeCount
364,50,174,0.15,9,134,random,-1,-1,-1,-1,0,0,-1,0,-1,-1,0,0,edgeCount
363,50,171,0.15,2,17,random,-1,6,4,4,2,28,8,4,8,11,4,14,edgeCount
362,50,174,0.15,3,34,random,-1,4,4,4,0,12,10,6,10,11,6,4,edgeCount
361,50,204,0.15,9,134,random,-1,4,4,4,0,18,-1,-5,-1,-1,-5,4,edgeCount
360,50,173,0.15,3,34,random,-1,4,6,4,0,0,8,4,8,8,4,0,edgeCount
359,50,187,0.15,6,84,random,-1,6,2,2,4,14,2,0,2,2,0,4,edgeCount
358,50,195,0.15,5,67,random,-1,9,4,3,6,54,9,6,5,5,2,14,edgeCount
357,50,207,0.15,3,34,random,-1,3,3,2,1,0,2,0,3,2,1,0,edgeCount
356,50,183,0.15,11,168,random,-1,-1,-1,-1,0,0,-1,0,-1,-1,0,0,edgeCount
355,50,195,0.15,8,118,random,-1,4,2,2,2,8,2,0,2,2,0,2,edgeCount
354,50,176,0.15,9,134,random,-1,-1,-1,5,-6,8,-1,-6,-1,-1,-6,2,edgeCount
353,50,182,0.15,6,84,random,-1,9,3,2,7,0,2,0,3,2,1,0,edgeCount
352,50,180,0.15,5,67,random,-1,3,10,3,0,6,5,2,5,5,2,2,edgeCount
351,50,177,0.15,5,67,random,-1,6,7,4,2,0,8,4,8,8,4,0,edgeCount
350,50,167,0.15,2,17,random,-1,3,3,3,0,16,3,0,3,3,0,8,edgeCount
349,50,161,0.15,5,67,random,-1,10,2,2,8,20,2,0,2,2,0,6,edgeCount
348,50,189,0.15,5,67,random,-1,11,7,4,7,16,-1,-5,6,8,2,4,edgeCount
347,50,188,0.15,2,17,random,-1,4,6,4,0,16,4,0,4,5,0,8,edgeCount
346,50,189,0.15,6,84,random,-1,4,6,4,0,0,6,2,6,6,2,0,edgeCount
345,50,194,0.15,9,134,random,-1,-1,-1,-1,0,0,-1,0,-1,-1,0,0,edgeCount
344,50,161,0.15,1,0,random,-1,4,4,4,0,0,4,0,4,4,0,0,edgeCount
343,50,187,0.15,10,151,random,-1,5,5,3,2,0,5,2,5,5,2,0,edgeCount
342,50,181,0.15,5,67,random,-1,2,7,2,0,16,2,0,3,2,1,4,edgeCount
341,50,189,0.15,5,67,random,-1,4,4,2,2,0,2,0,2,2,0,0,edgeCount
340,50,186,0.15,5,67,random,-1,10,10,3,7,0,-1,-4,-1,-1,-4,0,edgeCount
339,50,170,0.15,5,67,random,-1,5,5,4,1,0,6,2,6,6,2,0,edgeCount
338,50,178,0.15,5,67,random,-1,-1,-1,-1,0,6,-1,0,-1,-1,0,2,edgeCount
337,50,168,0.15,3,34,random,-1,2,2,2,0,14,2,0,2,2,0,6,edgeCount
336,50,180,0.15,4,50,random,-1,3,3,3,0,0,3,0,3,3,0,0,edgeCount
335,50,156,0.15,5,67,random,-1,12,6,4,8,0,-1,-5,-1,-1,-5,0,edgeCount
334,50,179,0.15,9,134,random,-1,-1,-1,5,-6,0,-1,-6,-1,-1,-6,0,edgeCount
333,50,186,0.15,3,34,random,-1,3,3,2,1,16,2,0,2,2,0,6,edgeCount
332,50,176,0.15,5,67,random,-1,-1,-1,4,-5,0,-1,-5,-1,-1,-5,0,edgeCount
331,50,179,0.15,5,67,random,-1,13,7,3,10,0,-1,-4,-1,-1,-4,0,edgeCount
330,50,193,0.15,10,151,random,-1,-1,-1,-1,0,0,-1,0,-1,-1,0,0,edgeCount
329,50,166,0.15,6,84,random,-1,4,3,3,1,6,12,9,12,12,9,2,edgeCount
328,50,185,0.15,8,118,random,-1,4,2,2,2,0,4,2,6,4,4,0,edgeCount
327,50,186,0.15,2,17,random,-1,3,3,3,0,18,3,0,3,3,0,10,edgeCount
326,50,161,0.15,5,67,random,-1,15,7,4,11,0,-1,-5,-1,-1,-5,0,edgeCount
325,50,185,0.15,5,67,random,-1,-1,-1,4,-5,0,-1,-5,-1,-1,-5,0,edgeCount
324,50,183,0.15,7,101,random,-1,-1,-1,-1,0,0,-1,0,-1,-1,0,0,edgeCount
323,50,168,0.15,7,101,random,-1,3,5,3,0,0,12,9,7,5,4,0,edgeCount
322,50,161,0.15,3,34,random,-1,-1,-1,4,-5,0,-1,-5,-1,-1,-5,0,edgeCount
321,50,190,0.15,5,67,random,-1,11,13,3,8,0,3,0,3,3,0,0,edgeCount
320,50,205,0.15,6,84,random,-1,3,8,2,1,76,2,0,6,2,4,18,edgeCount
319,50,183,0.15,5,67,random,-1,5,5,3,2,20,3,0,3,3,0,6,edgeCount
318,50,178,0.15,5,67,random,-1,15,4,4,11,6,-1,-5,-1,-1,-5,2,edgeCount
317,50,188,0.15,6,84,random,-1,6,3,3,3,0,3,0,3,3,0,0,edgeCount
316,50,188,0.15,9,134,random,-1,7,5,5,2,0,-1,-6,-1,-1,-6,0,edgeCount
315,50,204,0.15,7,101,random,-1,9,5,3,6,36,7,4,7,7,4,10,edgeCount
314,50,175,0.15,4,50,random,-1,3,4,3,0,24,5,2,5,5,2,8,edgeCount
313,50,213,0.15,6,84,random,-1,15,15,3,12,36,3,0,3,7,0,8,edgeCount
312,50,158,0.15,6,84,random,-1,-1,-1,5,-6,14,-1,-6,-1,-1,-6,4,edgeCount
311,50,187,0.15,5,67,random,-1,-1,-1,4,-5,28,-1,-5,-1,-1,-5,8,edgeCount
310,50,154,0.15,3,34,random,-1,3,6,3,0,0,3,0,3,3,0,0,edgeCount
309,50,158,0.15,6,84,random,-1,4,2,2,2,0,2,0,2,2,0,0,edgeCount
308,50,149,0.15,3,34,random,-1,4,3,3,1,10,3,0,3,3,0,4,edgeCount
307,50,175,0.15,5,67,random,-1,7,7,3,4,0,3,0,3,3,0,0,edgeCount
306,50,176,0.15,7,101,random,-1,11,5,3,8,16,-1,-4,-1,-1,-4,6,edgeCount
305,50,175,0.15,6,84,random,-1,14,10,4,10,0,-1,-5,-1,-1,-5,0,edgeCount
304,50,185,0.15,4,50,random,-1,3,3,3,0,22,3,0,3,3,0,6,edgeCount
303,50,175,0.15,5,67,random,-1,4,5,2,2,24,2,0,2,2,0,6,edgeCount
302,50,172,0.15,5,67,random,-1,-1,-1,4,-5,0,-1,-5,-1,-1,-5,0,edgeCount
301,50,177,0.15,6,84,random,-1,-1,-1,4,-5,34,-1,-5,13,11,9,10,edgeCount
300,50,185,0.15,5,67,random,-1,6,6,4,2,42,-1,-5,-1,-1,-5,10,edgeCount
299,50,149,0.15,3,34,random,-1,2,2,2,0,24,2,0,2,2,0,8,edgeCount
298,50,173,0.15,5,67,random,-1,5,5,3,2,0,3,0,3,3,0,0,edgeCount
297,50,166,0.15,10,151,random,-1,-1,-1,-1,0,4,-1,0,-1,-1,0,2,edgeCount
296,50,168,0.15,5,67,random,-1,19,15,3,16,0,5,2,5,5,2,0,edgeCount
295,50,178,0.15,6,84,random,-1,3,3,2,1,14,2,0,3,2,1,4,edgeCount
294,50,182,0.15,10,151,random,-1,-1,-1,-1,0,6,-1,0,-1,-1,0,2,edgeCount
293,50,175,0.15,4,50,random,-1,4,3,3,1,36,3,0,3,3,0,10,edgeCount
292,50,184,0.15,7,101,random,-1,-1,-1,-1,0,4,-1,0,-1,-1,0,2,edgeCount
291,50,178,0.15,5,67,random,-1,4,5,3,1,32,7,4,7,7,4,8,edgeCount
290,50,163,0.15,3,34,random,-1,4,6,4,0,28,-1,-5,-1,-1,-5,10,edgeCount
