rep,nrNodes,nrEdges,edgeProb,nrPaths,nrFails,failureModel,failurePercent,hopsRanked,hopsUnranked,spLength,stretch_mult,nodeAdditions,hopsPath,stretch_path,hopsRankedOne,hopsUnrankedOne,stretch_one,overallNodeAdditionsOne,treeChoice
1000,100,240,0.05,7,6,clustered,0.5;-0.15,27,42,5,22,0,23,18,23,23,18,0,shortest
999,100,254,0.05,2,1,clustered,0.5;-0.15,-1,-1,5,-6,26,-1,-6,-1,-1,-6,0,shortest
998,100,226,0.05,4,3,clustered,0.5;-0.15,19,19,5,14,8,-1,-6,-1,-1,-6,0,shortest
995,100,253,0.05,1,0,clustered,0.5;-0.15,-1,-1,8,-9,4,-1,-9,-1,-1,-9,4,shortest
993,100,251,0.05,3,2,clustered,0.5;-0.15,-1,-1,7,-8,6,-1,-8,-1,-1,-8,0,shortest
992,100,264,0.05,5,4,clustered,0.5;-0.15,-1,-1,5,-6,0,-1,-6,-1,-1,-6,0,shortest
991,100,252,0.05,3,2,clustered,0.5;-0.15,-1,-1,6,-7,20,-1,-7,-1,-1,-7,0,shortest
990,100,257,0.05,4,3,clustered,0.5;-0.15,5,5,3,2,0,5,2,5,5,2,0,shortest
989,100,250,0.05,2,1,clustered,0.5;-0.15,5,5,3,2,0,5,2,5,5,2,0,shortest
988,100,268,0.05,6,5,clustered,0.5;-0.15,-1,-1,5,-6,0,-1,-6,-1,-1,-6,0,shortest
987,100,285,0.05,5,4,clustered,0.5;-0.15,-1,-1,4,-5,0,-1,-5,-1,-1,-5,0,shortest
986,100,250,0.05,5,4,clustered,0.5;-0.15,16,16,4,12,0,12,8,12,12,8,0,shortest
982,100,273,0.05,4,3,clustered,0.5;-0.15,4,4,4,0,0,4,0,4,4,0,0,shortest
981,100,231,0.05,4,3,clustered,0.5;-0.15,38,38,6,32,10,-1,-7,-1,-1,-7,0,shortest
978,100,257,0.05,4,3,clustered,0.5;-0.15,10,10,5,5,0,-1,-6,-1,-1,-6,0,shortest
977,100,259,0.05,7,6,clustered,0.5;-0.15,-1,-1,5,-6,0,-1,-6,-1,-1,-6,0,shortest
976,100,236,0.05,3,2,clustered,0.5;-0.15,22,22,5,17,0,9,4,9,9,4,0,shortest
974,100,229,0.05,4,3,clustered,0.5;-0.15,4,4,4,0,2,8,4,4,4,0,0,shortest
973,100,233,0.05,5,4,clustered,0.5;-0.15,19,13,5,14,4,-1,-6,-1,-1,-6,0,shortest
972,100,255,0.05,6,5,clustered,0.5;-0.15,3,5,3,0,0,5,2,5,5,2,0,shortest
971,100,206,0.05,2,1,clustered,0.5;-0.15,18,22,6,12,2,-1,-7,-1,-1,-7,0,shortest
968,100,225,0.05,5,4,clustered,0.5;-0.15,20,20,5,15,0,-1,-6,-1,-1,-6,0,shortest
967,100,223,0.05,3,2,clustered,0.5;-0.15,-1,-1,7,-8,12,-1,-8,-1,-1,-8,0,shortest
966,100,241,0.05,4,3,clustered,0.5;-0.15,-1,-1,5,-6,12,-1,-6,-1,-1,-6,0,shortest
963,100,236,0.05,5,4,clustered,0.5;-0.15,4,4,4,0,0,4,0,4,4,0,0,shortest
962,100,248,0.05,7,6,clustered,0.5;-0.15,-1,-1,4,-5,4,-1,-5,-1,-1,-5,0,shortest
961,100,232,0.05,5,4,clustered,0.5;-0.15,-1,-1,5,-6,6,-1,-6,-1,-1,-6,0,shortest
958,100,263,0.05,3,2,clustered,0.5;-0.15,-1,-1,5,-6,12,-1,-6,-1,-1,-6,0,shortest
957,100,234,0.05,3,2,clustered,0.5;-0.15,4,4,4,0,12,6,2,4,4,0,0,shortest
956,100,284,0.05,8,7,clustered,0.5;-0.15,3,3,3,0,10,3,0,3,3,0,0,shortest
955,100,260,0.05,3,2,clustered,0.5;-0.15,2,2,2,0,0,2,0,2,2,0,0,shortest
954,100,264,0.05,5,4,clustered,0.5;-0.15,2,2,2,0,0,2,0,2,2,0,0,shortest
953,100,224,0.05,8,7,clustered,0.5;-0.15,-1,-1,5,-6,0,-1,-6,-1,-1,-6,0,shortest
952,100,242,0.05,7,6,clustered,0.5;-0.15,15,15,5,10,0,-1,-6,-1,-1,-6,0,shortest
951,100,242,0.05,4,3,clustered,0.5;-0.15,-1,-1,3,-4,0,-1,-4,-1,-1,-4,0,shortest
950,100,244,0.05,5,4,clustered,0.5;-0.15,9,9,5,4,0,9,4,9,9,4,0,shortest
949,100,215,0.05,3,2,clustered,0.5;-0.15,-1,-1,6,-7,12,-1,-7,-1,-1,-7,0,shortest
948,100,240,0.05,4,3,clustered,0.5;-0.15,-1,-1,5,-6,0,-1,-6,-1,-1,-6,0,shortest
947,100,256,0.05,4,3,clustered,0.5;-0.15,19,13,4,15,4,21,17,21,21,17,0,shortest
946,100,273,0.05,5,4,clustered,0.5;-0.15,-1,-1,4,-5,4,-1,-5,-1,-1,-5,0,shortest
945,100,272,0.05,4,3,clustered,0.5;-0.15,2,2,2,0,0,2,0,2,2,0,0,shortest
944,100,245,0.05,4,3,clustered,0.5;-0.15,2,2,2,0,16,2,0,2,2,0,0,shortest
943,100,242,0.05,5,4,clustered,0.5;-0.15,6,20,4,2,0,6,2,6,6,2,0,shortest
942,100,238,0.05,2,1,clustered,0.5;-0.15,3,3,3,0,28,3,0,3,3,0,0,shortest
941,100,275,0.05,3,2,clustered,0.5;-0.15,24,24,5,19,6,-1,-6,-1,-1,-6,0,shortest
940,100,262,0.05,5,4,clustered,0.5;-0.15,5,11,3,2,0,-1,-4,-1,-1,-4,0,shortest
939,100,255,0.05,3,2,clustered,0.5;-0.15,-1,-1,6,-7,10,-1,-7,-1,-1,-7,0,shortest
937,100,240,0.05,6,5,clustered,0.5;-0.15,-1,-1,6,-7,0,-1,-7,-1,-1,-7,0,shortest
936,100,250,0.05,6,5,clustered,0.5;-0.15,-1,-1,5,-6,10,-1,-6,-1,-1,-6,0,shortest
935,100,236,0.05,4,3,clustered,0.5;-0.15,-1,-1,6,-7,0,-1,-7,-1,-1,-7,0,shortest
934,100,229,0.05,1,0,clustered,0.5;-0.15,-1,-1,7,-8,4,-1,-8,-1,-1,-8,4,shortest
932,100,266,0.05,2,1,clustered,0.5;-0.15,23,21,5,18,20,-1,-6,-1,-1,-6,0,shortest
931,100,258,0.05,4,3,clustered,0.5;-0.15,4,4,2,2,14,2,0,2,2,0,0,shortest
930,100,240,0.05,2,1,clustered,0.5;-0.15,15,15,4,11,0,-1,-5,-1,-1,-5,0,shortest
929,100,258,0.05,5,4,clustered,0.5;-0.15,5,5,3,2,0,9,6,5,5,2,0,shortest
926,100,252,0.05,4,3,clustered,0.5;-0.15,7,5,5,2,4,-1,-6,-1,-1,-6,0,shortest
923,100,231,0.05,3,2,clustered,0.5;-0.15,-1,-1,5,-6,0,-1,-6,-1,-1,-6,0,shortest
922,100,256,0.05,4,3,clustered,0.5;-0.15,10,10,5,5,0,-1,-6,-1,-1,-6,0,shortest
921,100,252,0.05,4,3,clustered,0.5;-0.15,9,7,4,5,0,12,8,6,6,2,0,shortest
920,100,250,0.05,5,4,clustered,0.5;-0.15,11,11,5,6,4,-1,-6,-1,-1,-6,0,shortest
919,100,230,0.05,5,4,clustered,0.5;-0.15,-1,-1,5,-6,0,-1,-6,-1,-1,-6,0,shortest
918,100,245,0.05,4,3,clustered,0.5;-0.15,6,6,5,1,0,-1,-6,-1,-1,-6,0,shortest
917,100,235,0.05,4,3,clustered,0.5;-0.15,6,6,5,1,0,-1,-6,-1,-1,-6,0,shortest
916,100,277,0.05,6,5,clustered,0.5;-0.15,-1,-1,4,-5,0,-1,-5,-1,-1,-5,0,shortest
914,100,265,0.05,4,3,clustered,0.5;-0.15,12,12,4,8,14,12,8,8,8,4,0,shortest
913,100,237,0.05,3,2,clustered,0.5;-0.15,-1,-1,6,-7,0,-1,-7,-1,-1,-7,0,shortest
912,100,254,0.05,3,2,clustered,0.5;-0.15,-1,-1,4,-5,0,-1,-5,-1,-1,-5,0,shortest
910,100,261,0.05,2,1,clustered,0.5;-0.15,-1,-1,5,-6,0,-1,-6,-1,-1,-6,0,shortest
909,100,236,0.05,5,4,clustered,0.5;-0.15,-1,-1,6,-7,0,-1,-7,-1,-1,-7,0,shortest
908,100,259,0.05,1,0,clustered,0.5;-0.15,4,4,4,0,0,4,0,4,4,0,0,shortest
907,100,247,0.05,1,0,clustered,0.5;-0.15,-1,-1,6,-7,12,-1,-7,-1,-1,-7,12,shortest
906,100,228,0.05,2,1,clustered,0.5;-0.15,12,12,4,8,0,10,6,10,10,6,0,shortest
905,100,240,0.05,4,3,clustered,0.5;-0.15,15,15,3,12,24,5,2,3,3,0,0,shortest
904,100,237,0.05,2,1,clustered,0.5;-0.15,-1,-1,6,-7,8,-1,-7,-1,-1,-7,0,shortest
902,100,271,0.05,5,4,clustered,0.5;-0.15,-1,-1,4,-5,0,-1,-5,-1,-1,-5,0,shortest
901,100,254,0.05,4,3,clustered,0.5;-0.15,3,3,3,0,0,3,0,3,3,0,0,shortest
900,100,232,0.05,4,3,clustered,0.5;-0.15,14,16,5,9,0,-1,-6,-1,-1,-6,0,shortest
899,100,251,0.05,4,3,clustered,0.5;-0.15,-1,-1,6,-7,0,-1,-7,-1,-1,-7,0,shortest
897,100,252,0.05,6,5,clustered,0.5;-0.15,-1,-1,5,-6,4,-1,-6,-1,-1,-6,0,shortest
895,100,261,0.05,3,2,clustered,0.5;-0.15,-1,-1,6,-7,18,-1,-7,-1,-1,-7,0,shortest
894,100,242,0.05,5,4,clustered,0.5;-0.15,3,3,3,0,0,3,0,3,3,0,0,shortest
891,100,251,0.05,3,2,clustered,0.5;-0.15,9,9,5,4,0,-1,-6,-1,-1,-6,0,shortest
890,100,255,0.05,6,5,clustered,0.5;-0.15,21,21,5,16,0,19,14,25,25,20,0,shortest
889,100,229,0.05,3,2,clustered,0.5;-0.15,9,9,5,4,0,9,4,9,9,4,0,shortest
888,100,230,0.05,3,2,clustered,0.5;-0.15,-1,-1,4,-5,14,-1,-5,-1,-1,-5,0,shortest
887,100,227,0.05,3,2,clustered,0.5;-0.15,34,34,5,29,8,-1,-6,-1,-1,-6,0,shortest
886,100,243,0.05,3,2,clustered,0.5;-0.15,2,2,2,0,0,2,0,2,2,0,0,shortest
885,100,271,0.05,5,4,clustered,0.5;-0.15,7,9,4,3,12,-1,-5,-1,-1,-5,0,shortest
884,100,261,0.05,4,3,clustered,0.5;-0.15,37,33,6,31,24,-1,-7,-1,-1,-7,0,shortest
883,100,257,0.05,3,2,clustered,0.5;-0.15,38,38,6,32,0,16,10,16,16,10,0,shortest
882,100,252,0.05,4,3,clustered,0.5;-0.15,-1,-1,5,-6,22,-1,-6,-1,-1,-6,0,shortest
881,100,232,0.05,5,4,clustered,0.5;-0.15,-1,-1,6,-7,0,-1,-7,-1,-1,-7,0,shortest
878,100,257,0.05,3,2,clustered,0.5;-0.15,-1,-1,5,-6,26,-1,-6,-1,-1,-6,0,shortest
877,100,271,0.05,3,2,clustered,0.5;-0.15,12,14,4,8,32,-1,-5,-1,-1,-5,0,shortest
875,100,209,0.05,1,0,clustered,0.5;-0.15,-1,-1,7,-8,10,-1,-8,-1,-1,-8,10,shortest
874,100,269,0.05,5,4,clustered,0.5;-0.15,-1,-1,6,-7,6,-1,-7,-1,-1,-7,0,shortest
873,100,251,0.05,3,2,clustered,0.5;-0.15,14,14,4,10,12,-1,-5,-1,-1,-5,0,shortest
872,100,254,0.05,5,4,clustered,0.5;-0.15,7,7,5,2,16,-1,-6,-1,-1,-6,0,shortest
871,100,260,0.05,3,2,clustered,0.5;-0.15,-1,-1,5,-6,0,-1,-6,-1,-1,-6,0,shortest
870,100,240,0.05,2,1,clustered,0.5;-0.15,15,17,5,10,0,11,6,11,11,6,0,shortest
869,100,233,0.05,6,5,clustered,0.5;-0.15,3,3,3,0,4,3,0,3,3,0,0,shortest
868,100,234,0.05,5,4,clustered,0.5;-0.15,3,3,3,0,16,3,0,3,3,0,0,shortest
867,100,236,0.05,2,1,clustered,0.5;-0.15,12,18,4,8,0,8,4,8,8,4,0,shortest
866,100,240,0.05,3,2,clustered,0.5;-0.15,9,7,4,5,0,-1,-5,-1,-1,-5,0,shortest
865,100,255,0.05,1,0,clustered,0.5;-0.15,-1,-1,5,-6,0,-1,-6,-1,-1,-6,0,shortest
864,100,248,0.05,4,3,clustered,0.5;-0.15,5,8,5,0,0,5,0,5,5,0,0,shortest
863,100,255,0.05,3,2,clustered,0.5;-0.15,11,11,5,6,16,-1,-6,-1,-1,-6,0,shortest
858,100,256,0.05,4,3,clustered,0.5;-0.15,32,36,6,26,4,-1,-7,-1,-1,-7,0,shortest
856,100,239,0.05,5,4,clustered,0.5;-0.15,3,3,3,0,0,3,0,3,3,0,0,shortest
855,100,248,0.05,5,4,clustered,0.5;-0.15,-1,-1,6,-7,0,-1,-7,-1,-1,-7,0,shortest
854,100,237,0.05,6,5,clustered,0.5;-0.15,-1,-1,6,-7,0,-1,-7,-1,-1,-7,0,shortest
853,100,230,0.05,4,3,clustered,0.5;-0.15,3,13,3,0,18,-1,-4,-1,-1,-4,0,shortest
852,100,235,0.05,5,4,clustered,0.5;-0.15,4,4,4,0,4,4,0,4,4,0,0,shortest
850,100,252,0.05,3,2,clustered,0.5;-0.15,2,2,2,0,0,2,0,2,2,0,0,shortest
849,100,239,0.05,1,0,clustered,0.5;-0.15,-1,-1,6,-7,12,-1,-7,-1,-1,-7,12,shortest
848,100,251,0.05,7,6,clustered,0.5;-0.15,18,16,6,12,0,22,16,22,22,16,0,shortest
847,100,271,0.05,4,3,clustered,0.5;-0.15,-1,-1,5,-6,42,-1,-6,-1,-1,-6,0,shortest
846,100,270,0.05,3,2,clustered,0.5;-0.15,-1,-1,4,-5,4,-1,-5,-1,-1,-5,0,shortest
845,100,252,0.05,2,1,clustered,0.5;-0.15,36,36,4,32,18,-1,-5,-1,-1,-5,0,shortest
844,100,250,0.05,4,3,clustered,0.5;-0.15,7,7,5,2,0,11,6,11,11,6,0,shortest
843,100,243,0.05,2,1,clustered,0.5;-0.15,3,3,3,0,0,3,0,3,3,0,0,shortest
842,100,252,0.05,6,5,clustered,0.5;-0.15,16,16,4,12,8,16,12,16,16,12,0,shortest
841,100,237,0.05,5,4,clustered,0.5;-0.15,-1,-1,6,-7,10,-1,-7,-1,-1,-7,0,shortest
838,100,245,0.05,1,0,clustered,0.5;-0.15,-1,-1,6,-7,8,-1,-7,-1,-1,-7,8,shortest
837,100,242,0.05,3,2,clustered,0.5;-0.15,27,27,5,22,0,13,8,13,13,8,0,shortest
836,100,263,0.05,3,2,clustered,0.5;-0.15,-1,-1,4,-5,38,-1,-5,-1,-1,-5,0,shortest
835,100,232,0.05,2,1,clustered,0.5;-0.15,28,28,5,23,30,-1,-6,-1,-1,-6,0,shortest
834,100,219,0.05,1,0,clustered,0.5;-0.15,4,4,4,0,0,4,0,4,4,0,0,shortest
833,100,227,0.05,1,0,clustered,0.5;-0.15,-1,-1,6,-7,2,-1,-7,-1,-1,-7,2,shortest
832,100,228,0.05,3,2,clustered,0.5;-0.15,3,3,3,0,0,3,0,3,3,0,0,shortest
831,100,264,0.05,5,4,clustered,0.5;-0.15,18,28,4,14,6,21,17,21,21,17,0,shortest
830,100,224,0.05,3,2,clustered,0.5;-0.15,-1,-1,4,-5,0,-1,-5,-1,-1,-5,0,shortest
829,100,269,0.05,5,4,clustered,0.5;-0.15,22,40,4,18,0,10,6,16,16,12,0,shortest
828,100,234,0.05,5,4,clustered,0.5;-0.15,-1,-1,4,-5,0,-1,-5,-1,-1,-5,0,shortest
827,100,253,0.05,7,6,clustered,0.5;-0.15,3,3,3,0,0,3,0,3,3,0,0,shortest
826,100,237,0.05,2,1,clustered,0.5;-0.15,-1,-1,6,-7,0,-1,-7,-1,-1,-7,0,shortest
825,100,259,0.05,2,1,clustered,0.5;-0.15,21,21,5,16,0,-1,-6,-1,-1,-6,0,shortest
823,100,250,0.05,7,6,clustered,0.5;-0.15,11,11,3,8,0,3,0,11,11,8,0,shortest
822,100,261,0.05,4,3,clustered,0.5;-0.15,-1,-1,4,-5,0,-1,-5,-1,-1,-5,0,shortest
820,100,241,0.05,1,0,clustered,0.5;-0.15,-1,-1,5,-6,0,-1,-6,-1,-1,-6,0,shortest
819,100,262,0.05,5,4,clustered,0.5;-0.15,15,31,5,10,6,-1,-6,-1,-1,-6,0,shortest
818,100,257,0.05,5,4,clustered,0.5;-0.15,-1,-1,5,-6,0,-1,-6,-1,-1,-6,0,shortest
817,100,271,0.05,4,3,clustered,0.5;-0.15,5,5,3,2,0,5,2,5,5,2,0,shortest
816,100,245,0.05,3,2,clustered,0.5;-0.15,34,34,6,28,0,20,14,20,20,14,0,shortest
815,100,287,0.05,7,6,clustered,0.5;-0.15,5,5,3,2,4,5,2,5,5,2,0,shortest
813,100,220,0.05,2,1,clustered,0.5;-0.15,-1,-1,7,-8,16,-1,-8,-1,-1,-8,0,shortest
810,100,244,0.05,5,4,clustered,0.5;-0.15,27,27,5,22,0,13,8,13,13,8,0,shortest
809,100,212,0.05,3,2,clustered,0.5;-0.15,13,17,5,8,4,-1,-6,-1,-1,-6,0,shortest
808,100,254,0.05,4,3,clustered,0.5;-0.15,-1,-1,6,-7,0,-1,-7,-1,-1,-7,0,shortest
807,100,263,0.05,6,5,clustered,0.5;-0.15,6,12,4,2,12,14,10,16,16,12,0,shortest
806,100,239,0.05,3,2,clustered,0.5;-0.15,6,6,4,2,0,6,2,6,6,2,0,shortest
803,100,247,0.05,5,4,clustered,0.5;-0.15,3,3,3,0,0,3,0,3,3,0,0,shortest
802,100,231,0.05,1,0,clustered,0.5;-0.15,-1,-1,7,-8,2,-1,-8,-1,-1,-8,2,shortest
800,100,255,0.05,2,1,clustered,0.5;-0.15,-1,-1,6,-7,8,-1,-7,-1,-1,-7,0,shortest
799,100,252,0.05,7,6,clustered,0.5;-0.15,21,13,4,17,0,15,11,21,21,17,0,shortest
798,100,238,0.05,2,1,clustered,0.5;-0.15,8,6,5,3,18,-1,-6,-1,-1,-6,0,shortest
796,100,241,0.05,5,4,clustered,0.5;-0.15,-1,-1,5,-6,0,-1,-6,-1,-1,-6,0,shortest
795,100,246,0.05,4,3,clustered,0.5;-0.15,3,3,3,0,0,3,0,5,5,2,0,shortest
794,100,249,0.05,3,2,clustered,0.5;-0.15,-1,-1,5,-6,0,-1,-6,-1,-1,-6,0,shortest
793,100,250,0.05,4,3,clustered,0.5;-0.15,10,10,4,6,12,-1,-5,-1,-1,-5,0,shortest
792,100,262,0.05,5,4,clustered,0.5;-0.15,3,3,3,0,0,3,0,3,3,0,0,shortest
791,100,260,0.05,2,1,clustered,0.5;-0.15,-1,-1,6,-7,10,-1,-7,-1,-1,-7,0,shortest
790,100,251,0.05,4,3,clustered,0.5;-0.15,22,20,5,17,12,-1,-6,-1,-1,-6,0,shortest
788,100,257,0.05,4,3,clustered,0.5;-0.15,-1,-1,6,-7,0,-1,-7,-1,-1,-7,0,shortest
787,100,229,0.05,4,3,clustered,0.5;-0.15,6,6,4,2,2,6,2,6,6,2,0,shortest
786,100,248,0.05,3,2,clustered,0.5;-0.15,12,14,4,8,0,-1,-5,-1,-1,-5,0,shortest
784,100,236,0.05,3,2,clustered,0.5;-0.15,7,15,5,2,0,7,2,7,7,2,0,shortest
783,100,258,0.05,1,0,clustered,0.5;-0.15,-1,-1,6,-7,12,-1,-7,-1,-1,-7,12,shortest
782,100,236,0.05,3,2,clustered,0.5;-0.15,-1,-1,6,-7,16,-1,-7,-1,-1,-7,0,shortest
779,100,241,0.05,5,4,clustered,0.5;-0.15,3,3,3,0,0,3,0,3,3,0,0,shortest
778,100,213,0.05,1,0,clustered,0.5;-0.15,5,5,5,0,0,5,0,5,5,0,0,shortest
774,100,250,0.05,5,4,clustered,0.5;-0.15,34,26,5,29,0,-1,-6,-1,-1,-6,0,shortest
773,100,266,0.05,6,5,clustered,0.5;-0.15,41,45,5,36,0,-1,-6,-1,-1,-6,0,shortest
771,100,229,0.05,3,2,clustered,0.5;-0.15,-1,-1,6,-7,0,-1,-7,-1,-1,-7,0,shortest
770,100,246,0.05,6,5,clustered,0.5;-0.15,14,14,4,10,0,10,6,10,10,6,0,shortest
768,100,265,0.05,6,5,clustered,0.5;-0.15,47,43,6,41,0,-1,-7,-1,-1,-7,0,shortest
767,100,220,0.05,2,1,clustered,0.5;-0.15,-1,-1,6,-7,0,-1,-7,-1,-1,-7,0,shortest
766,100,258,0.05,2,1,clustered,0.5;-0.15,4,12,4,0,0,4,0,4,4,0,0,shortest
765,100,251,0.05,3,2,clustered,0.5;-0.15,11,11,3,8,0,5,2,3,3,0,0,shortest
762,100,305,0.05,5,4,clustered,0.5;-0.15,15,15,4,11,0,13,9,13,13,9,0,shortest
761,100,240,0.05,6,5,clustered,0.5;-0.15,19,19,5,14,0,5,0,9,9,4,0,shortest
760,100,235,0.05,5,4,clustered,0.5;-0.15,5,9,5,0,8,-1,-6,-1,-1,-6,0,shortest
759,100,216,0.05,3,2,clustered,0.5;-0.15,-1,-1,5,-6,0,-1,-6,-1,-1,-6,0,shortest
758,100,240,0.05,3,2,clustered,0.5;-0.15,16,16,2,14,10,2,0,2,2,0,0,shortest
757,100,232,0.05,2,1,clustered,0.5;-0.15,-1,-1,5,-6,8,-1,-6,-1,-1,-6,0,shortest
755,100,238,0.05,6,5,clustered,0.5;-0.15,8,8,4,4,0,8,4,8,8,4,0,shortest
754,100,224,0.05,4,3,clustered,0.5;-0.15,20,28,4,16,6,-1,-5,-1,-1,-5,0,shortest
753,100,265,0.05,5,4,clustered,0.5;-0.15,31,35,5,26,14,-1,-6,-1,-1,-6,0,shortest
752,100,248,0.05,3,2,clustered,0.5;-0.15,22,22,6,16,8,-1,-7,-1,-1,-7,0,shortest
751,100,260,0.05,4,3,clustered,0.5;-0.15,-1,-1,6,-7,16,-1,-7,-1,-1,-7,0,shortest
750,100,264,0.05,6,5,clustered,0.5;-0.15,2,2,2,0,0,2,0,2,2,0,0,shortest
749,100,256,0.05,5,4,clustered,0.5;-0.15,-1,-1,5,-6,0,-1,-6,-1,-1,-6,0,shortest
748,100,244,0.05,4,3,clustered,0.5;-0.15,-1,-1,4,-5,0,-1,-5,-1,-1,-5,0,shortest
747,100,242,0.05,4,3,clustered,0.5;-0.15,-1,-1,5,-6,32,-1,-6,-1,-1,-6,0,shortest
743,100,257,0.05,4,3,clustered,0.5;-0.15,3,3,3,0,0,3,0,3,3,0,0,shortest
742,100,243,0.05,5,4,clustered,0.5;-0.15,15,15,5,10,0,7,2,7,7,2,0,shortest
741,100,249,0.05,1,0,clustered,0.5;-0.15,-1,-1,7,-8,12,-1,-8,-1,-1,-8,12,shortest
740,100,242,0.05,6,5,clustered,0.5;-0.15,2,2,2,0,0,2,0,2,2,0,0,shortest
737,100,255,0.05,5,4,clustered,0.5;-0.15,6,6,4,2,0,6,2,6,6,2,0,shortest
736,100,271,0.05,7,6,clustered,0.5;-0.15,37,37,4,33,0,-1,-5,-1,-1,-5,0,shortest
735,100,265,0.05,6,5,clustered,0.5;-0.15,3,3,3,0,12,3,0,3,3,0,0,shortest
734,100,244,0.05,3,2,clustered,0.5;-0.15,-1,-1,5,-6,18,-1,-6,-1,-1,-6,0,shortest
733,100,264,0.05,5,4,clustered,0.5;-0.15,2,2,2,0,0,2,0,2,2,0,0,shortest
732,100,256,0.05,5,4,clustered,0.5;-0.15,-1,-1,6,-7,0,-1,-7,-1,-1,-7,0,shortest
731,100,234,0.05,4,3,clustered,0.5;-0.15,-1,-1,5,-6,0,-1,-6,-1,-1,-6,0,shortest
730,100,270,0.05,6,5,clustered,0.5;-0.15,8,8,5,3,10,-1,-6,-1,-1,-6,0,shortest
729,100,246,0.05,1,0,clustered,0.5;-0.15,5,9,5,0,8,-1,-6,5,9,0,8,shortest
728,100,265,0.05,3,2,clustered,0.5;-0.15,2,2,2,0,0,2,0,2,2,0,0,shortest
727,100,236,0.05,3,2,clustered,0.5;-0.15,-1,-1,5,-6,0,-1,-6,-1,-1,-6,0,shortest
724,100,241,0.05,3,2,clustered,0.5;-0.15,8,8,4,4,0,8,4,8,8,4,0,shortest
723,100,246,0.05,4,3,clustered,0.5;-0.15,40,40,4,36,0,12,8,6,6,2,0,shortest
722,100,263,0.05,6,5,clustered,0.5;-0.15,11,11,4,7,20,12,8,12,12,8,0,shortest
721,100,278,0.05,3,2,clustered,0.5;-0.15,30,40,5,25,14,-1,-6,-1,-1,-6,0,shortest
720,100,254,0.05,4,3,clustered,0.5;-0.15,4,8,4,0,0,4,0,4,4,0,0,shortest
719,100,262,0.05,4,3,clustered,0.5;-0.15,15,7,5,10,0,-1,-6,-1,-1,-6,0,shortest
718,100,219,0.05,3,2,clustered,0.5;-0.15,3,7,3,0,0,3,0,3,3,0,0,shortest
717,100,239,0.05,5,4,clustered,0.5;-0.15,2,2,2,0,0,2,0,2,2,0,0,shortest
716,100,237,0.05,2,1,clustered,0.5;-0.15,-1,-1,7,-8,10,-1,-8,-1,-1,-8,0,shortest
714,100,255,0.05,3,2,clustered,0.5;-0.15,8,6,5,3,0,14,9,14,14,9,0,shortest
713,100,254,0.05,5,4,clustered,0.5;-0.15,22,22,4,18,0,-1,-5,-1,-1,-5,0,shortest
712,100,239,0.05,3,2,clustered,0.5;-0.15,17,27,5,12,4,-1,-6,9,9,4,0,shortest
711,100,271,0.05,4,3,clustered,0.5;-0.15,6,12,4,2,12,-1,-5,-1,-1,-5,0,shortest
710,100,256,0.05,4,3,clustered,0.5;-0.15,15,9,4,11,10,-1,-5,-1,-1,-5,0,shortest
707,100,235,0.05,3,2,clustered,0.5;-0.15,-1,-1,5,-6,0,-1,-6,-1,-1,-6,0,shortest
706,100,252,0.05,6,5,clustered,0.5;-0.15,-1,-1,5,-6,10,-1,-6,-1,-1,-6,0,shortest
705,100,263,0.05,3,2,clustered,0.5;-0.15,14,14,5,9,0,-1,-6,-1,-1,-6,0,shortest
703,100,258,0.05,5,4,clustered,0.5;-0.15,16,18,4,12,0,-1,-5,-1,-1,-5,0,shortest
701,100,241,0.05,3,2,clustered,0.5;-0.15,2,2,2,0,0,2,0,2,2,0,0,shortest
697,100,249,0.05,6,5,clustered,0.5;-0.15,-1,-1,6,-7,10,-1,-7,-1,-1,-7,0,shortest
696,100,254,0.05,3,2,clustered,0.5;-0.15,3,3,3,0,0,3,0,3,3,0,0,shortest
695,100,252,0.05,5,4,clustered,0.5;-0.15,43,43,7,36,4,-1,-8,-1,-1,-8,0,shortest
694,100,239,0.05,3,2,clustered,0.5;-0.15,4,20,4,0,0,4,0,4,4,0,0,shortest
692,100,239,0.05,3,2,clustered,0.5;-0.15,4,8,4,0,0,-1,-5,-1,-1,-5,0,shortest
690,100,264,0.05,3,2,clustered,0.5;-0.15,-1,-1,5,-6,10,-1,-6,-1,-1,-6,0,shortest
689,100,265,0.05,2,1,clustered,0.5;-0.15,5,5,5,0,0,-1,-6,-1,-1,-6,0,shortest
688,100,257,0.05,3,2,clustered,0.5;-0.15,6,6,4,2,0,-1,-5,-1,-1,-5,0,shortest
686,100,267,0.05,3,2,clustered,0.5;-0.15,-1,-1,5,-6,30,-1,-6,-1,-1,-6,0,shortest
685,100,256,0.05,6,5,clustered,0.5;-0.15,3,3,3,0,10,3,0,3,3,0,0,shortest
684,100,243,0.05,3,2,clustered,0.5;-0.15,3,15,3,0,16,3,0,3,3,0,0,shortest
683,100,255,0.05,1,0,clustered,0.5;-0.15,-1,-1,7,-8,4,-1,-8,-1,-1,-8,4,shortest
682,100,266,0.05,3,2,clustered,0.5;-0.15,4,12,4,0,0,14,10,14,14,10,0,shortest
680,100,253,0.05,4,3,clustered,0.5;-0.15,-1,-1,5,-6,0,-1,-6,-1,-1,-6,0,shortest
677,100,257,0.05,7,6,clustered,0.5;-0.15,9,9,3,6,0,5,2,9,9,6,0,shortest
676,100,262,0.05,2,1,clustered,0.5;-0.15,-1,-1,6,-7,14,-1,-7,-1,-1,-7,0,shortest
675,100,241,0.05,3,2,clustered,0.5;-0.15,42,40,6,36,0,-1,-7,-1,-1,-7,0,shortest
674,100,250,0.05,7,6,clustered,0.5;-0.15,6,8,4,2,0,6,2,6,6,2,0,shortest
673,100,227,0.05,3,2,clustered,0.5;-0.15,7,7,3,4,0,5,2,5,5,2,0,shortest
672,100,265,0.05,3,2,clustered,0.5;-0.15,4,4,4,0,6,-1,-5,-1,-1,-5,0,shortest
671,100,242,0.05,4,3,clustered,0.5;-0.15,3,3,3,0,0,3,0,3,3,0,0,shortest
670,100,269,0.05,4,3,clustered,0.5;-0.15,46,38,6,40,6,-1,-7,-1,-1,-7,0,shortest
669,100,249,0.05,4,3,clustered,0.5;-0.15,19,17,5,14,0,9,4,9,9,4,0,shortest
666,100,220,0.05,2,1,clustered,0.5;-0.15,5,11,5,0,12,-1,-6,-1,-1,-6,0,shortest
665,100,238,0.05,2,1,clustered,0.5;-0.15,-1,-1,7,-8,12,-1,-8,-1,-1,-8,0,shortest
664,100,243,0.05,2,1,clustered,0.5;-0.15,-1,-1,6,-7,0,-1,-7,-1,-1,-7,0,shortest
663,100,262,0.05,1,0,clustered,0.5;-0.15,3,11,3,0,20,3,0,3,11,0,20,shortest
662,100,256,0.05,2,1,clustered,0.5;-0.15,6,12,5,1,8,-1,-6,-1,-1,-6,0,shortest
661,100,258,0.05,4,3,clustered,0.5;-0.15,8,12,5,3,6,13,8,13,13,8,0,shortest
660,100,275,0.05,5,4,clustered,0.5;-0.15,-1,-1,5,-6,30,-1,-6,-1,-1,-6,0,shortest
659,100,249,0.05,5,4,clustered,0.5;-0.15,3,3,3,0,0,3,0,3,3,0,0,shortest
658,100,261,0.05,3,2,clustered,0.5;-0.15,-1,-1,6,-7,0,-1,-7,-1,-1,-7,0,shortest
656,100,232,0.05,4,3,clustered,0.5;-0.15,-1,-1,5,-6,0,-1,-6,-1,-1,-6,0,shortest
654,100,239,0.05,2,1,clustered,0.5;-0.15,19,19,5,14,14,-1,-6,-1,-1,-6,0,shortest
653,100,234,0.05,4,3,clustered,0.5;-0.15,15,21,5,10,6,9,4,9,9,4,0,shortest
652,100,268,0.05,4,3,clustered,0.5;-0.15,4,8,4,0,40,6,2,6,6,2,0,shortest
651,100,247,0.05,5,4,clustered,0.5;-0.15,-1,-1,4,-5,0,-1,-5,-1,-1,-5,0,shortest
650,100,248,0.05,2,1,clustered,0.5;-0.15,-1,-1,6,-7,12,-1,-7,-1,-1,-7,0,shortest
649,100,233,0.05,3,2,clustered,0.5;-0.15,-1,-1,5,-6,0,-1,-6,-1,-1,-6,0,shortest
648,100,244,0.05,3,2,clustered,0.5;-0.15,-1,-1,5,-6,0,-1,-6,-1,-1,-6,0,shortest
647,100,264,0.05,5,4,clustered,0.5;-0.15,-1,-1,5,-6,0,-1,-6,-1,-1,-6,0,shortest
646,100,260,0.05,5,4,clustered,0.5;-0.15,9,9,6,3,6,-1,-7,-1,-1,-7,0,shortest
645,100,252,0.05,4,3,clustered,0.5;-0.15,-1,-1,5,-6,0,-1,-6,-1,-1,-6,0,shortest
644,100,227,0.05,3,2,clustered,0.5;-0.15,20,20,4,16,10,4,0,4,4,0,0,shortest
643,100,259,0.05,5,4,clustered,0.5;-0.15,2,2,2,0,0,2,0,2,2,0,0,shortest
642,100,242,0.05,3,2,clustered,0.5;-0.15,15,21,5,10,10,-1,-6,-1,-1,-6,0,shortest
641,100,259,0.05,5,4,clustered,0.5;-0.15,-1,-1,4,-5,0,-1,-5,-1,-1,-5,0,shortest
640,100,251,0.05,8,7,clustered,0.5;-0.15,-1,-1,4,-5,0,-1,-5,-1,-1,-5,0,shortest
639,100,240,0.05,5,4,clustered,0.5;-0.15,20,12,4,16,0,16,12,12,12,8,0,shortest
638,100,287,0.05,8,7,clustered,0.5;-0.15,-1,-1,5,-6,0,-1,-6,-1,-1,-6,0,shortest
637,100,262,0.05,2,1,clustered,0.5;-0.15,-1,-1,6,-7,12,-1,-7,-1,-1,-7,0,shortest
636,100,238,0.05,2,1,clustered,0.5;-0.15,-1,-1,6,-7,4,-1,-7,-1,-1,-7,0,shortest
634,100,266,0.05,5,4,clustered,0.5;-0.15,10,10,3,7,6,7,4,7,7,4,0,shortest
633,100,232,0.05,5,4,clustered,0.5;-0.15,4,4,4,0,0,10,6,4,4,0,0,shortest
631,100,248,0.05,4,3,clustered,0.5;-0.15,-1,-1,6,-7,10,-1,-7,-1,-1,-7,0,shortest
630,100,258,0.05,4,3,clustered,0.5;-0.15,15,15,5,10,14,-1,-6,-1,-1,-6,0,shortest
628,100,223,0.05,3,2,clustered,0.5;-0.15,-1,-1,6,-7,4,-1,-7,-1,-1,-7,0,shortest
627,100,258,0.05,7,6,clustered,0.5;-0.15,4,20,4,0,10,4,0,8,8,4,0,shortest
626,100,255,0.05,4,3,clustered,0.5;-0.15,-1,-1,5,-6,4,-1,-6,-1,-1,-6,0,shortest
625,100,239,0.05,5,4,clustered,0.5;-0.15,3,3,3,0,0,3,0,3,3,0,0,shortest
621,100,260,0.05,5,4,clustered,0.5;-0.15,3,3,3,0,0,3,0,3,3,0,0,shortest
620,100,251,0.05,2,1,clustered,0.5;-0.15,-1,-1,5,-6,14,-1,-6,-1,-1,-6,0,shortest
617,100,234,0.05,8,7,clustered,0.5;-0.15,32,32,4,28,4,-1,-5,-1,-1,-5,0,shortest
615,100,251,0.05,4,3,clustered,0.5;-0.15,-1,-1,5,-6,0,-1,-6,-1,-1,-6,0,shortest
614,100,249,0.05,3,2,clustered,0.5;-0.15,3,3,3,0,10,3,0,3,3,0,0,shortest
613,100,248,0.05,5,4,clustered,0.5;-0.15,15,33,5,10,0,15,10,15,15,10,0,shortest
611,100,267,0.05,4,3,clustered,0.5;-0.15,-1,-1,5,-6,12,-1,-6,-1,-1,-6,0,shortest
609,100,233,0.05,4,3,clustered,0.5;-0.15,29,29,5,24,0,-1,-6,-1,-1,-6,0,shortest
608,100,238,0.05,4,3,clustered,0.5;-0.15,16,16,4,12,6,10,6,10,10,6,0,shortest
606,100,230,0.05,3,2,clustered,0.5;-0.15,24,30,5,19,10,-1,-6,-1,-1,-6,0,shortest
605,100,265,0.05,6,5,clustered,0.5;-0.15,41,45,3,38,6,-1,-4,-1,-1,-4,0,shortest
604,100,246,0.05,3,2,clustered,0.5;-0.15,20,28,4,16,0,12,8,12,12,8,0,shortest
603,100,225,0.05,3,2,clustered,0.5;-0.15,9,17,5,4,10,-1,-6,-1,-1,-6,0,shortest
602,100,244,0.05,4,3,clustered,0.5;-0.15,15,15,5,10,0,-1,-6,-1,-1,-6,0,shortest
601,100,238,0.05,4,3,clustered,0.5;-0.15,9,19,5,4,4,-1,-6,-1,-1,-6,0,shortest
600,100,270,0.05,3,2,clustered,0.5;-0.15,-1,-1,5,-6,2,-1,-6,-1,-1,-6,0,shortest
599,100,240,0.05,3,2,clustered,0.5;-0.15,7,13,5,2,6,-1,-6,-1,-1,-6,0,shortest
598,100,255,0.05,4,3,clustered,0.5;-0.15,6,6,4,2,10,-1,-5,6,6,2,0,shortest
597,100,223,0.05,3,2,clustered,0.5;-0.15,7,5,5,2,0,-1,-6,-1,-1,-6,0,shortest
596,100,258,0.05,5,4,clustered,0.5;-0.15,2,2,2,0,0,2,0,2,2,0,0,shortest
595,100,227,0.05,5,4,clustered,0.5;-0.15,3,3,3,0,0,14,11,3,3,0,0,shortest
594,100,249,0.05,7,6,clustered,0.5;-0.15,24,10,6,18,0,10,4,10,10,4,0,shortest
593,100,253,0.05,2,1,clustered,0.5;-0.15,-1,-1,6,-7,24,-1,-7,-1,-1,-7,0,shortest
589,100,210,0.05,3,2,clustered,0.5;-0.15,6,6,4,2,2,4,0,10,10,6,0,shortest
587,100,218,0.05,3,2,clustered,0.5;-0.15,-1,-1,6,-7,0,-1,-7,-1,-1,-7,0,shortest
585,100,236,0.05,4,3,clustered,0.5;-0.15,4,14,4,0,6,4,0,8,8,4,0,shortest
584,100,219,0.05,3,2,clustered,0.5;-0.15,21,31,6,15,26,-1,-7,-1,-1,-7,0,shortest
583,100,214,0.05,3,2,clustered,0.5;-0.15,4,10,3,1,8,-1,-4,-1,-1,-4,0,shortest
582,100,259,0.05,4,3,clustered,0.5;-0.15,-1,-1,4,-5,8,-1,-5,-1,-1,-5,0,shortest
580,100,226,0.05,4,3,clustered,0.5;-0.15,-1,-1,4,-5,0,-1,-5,-1,-1,-5,0,shortest
579,100,246,0.05,1,0,clustered,0.5;-0.15,3,3,3,0,0,3,0,3,3,0,0,shortest
578,100,223,0.05,3,2,clustered,0.5;-0.15,-1,-1,5,-6,0,-1,-6,-1,-1,-6,0,shortest
577,100,249,0.05,6,5,clustered,0.5;-0.15,3,3,3,0,0,3,0,3,3,0,0,shortest
575,100,228,0.05,4,3,clustered,0.5;-0.15,-1,-1,6,-7,6,-1,-7,-1,-1,-7,0,shortest
574,100,249,0.05,3,2,clustered,0.5;-0.15,-1,-1,5,-6,0,-1,-6,-1,-1,-6,0,shortest
573,100,259,0.05,4,3,clustered,0.5;-0.15,23,19,4,19,0,10,6,10,10,6,0,shortest
572,100,262,0.05,6,5,clustered,0.5;-0.15,-1,-1,5,-6,0,-1,-6,-1,-1,-6,0,shortest
571,100,251,0.05,4,3,clustered,0.5;-0.15,23,21,5,18,12,-1,-6,-1,-1,-6,0,shortest
569,100,249,0.05,3,2,clustered,0.5;-0.15,3,3,3,0,22,3,0,3,3,0,0,shortest
568,100,256,0.05,7,6,clustered,0.5;-0.15,6,6,2,4,6,6,4,6,6,4,0,shortest
567,100,272,0.05,6,5,clustered,0.5;-0.15,17,17,5,12,0,25,20,25,25,20,0,shortest
566,100,241,0.05,3,2,clustered,0.5;-0.15,4,8,4,0,0,-1,-5,-1,-1,-5,0,shortest
565,100,256,0.05,3,2,clustered,0.5;-0.15,47,57,5,42,12,-1,-6,-1,-1,-6,0,shortest
564,100,233,0.05,1,0,clustered,0.5;-0.15,-1,-1,6,-7,6,-1,-7,-1,-1,-7,6,shortest
563,100,238,0.05,4,3,clustered,0.5;-0.15,-1,-1,5,-6,0,-1,-6,-1,-1,-6,0,shortest
562,100,220,0.05,2,1,clustered,0.5;-0.15,17,13,5,12,0,-1,-6,-1,-1,-6,0,shortest
561,100,255,0.05,3,2,clustered,0.5;-0.15,25,25,4,21,26,-1,-5,-1,-1,-5,0,shortest
559,100,271,0.05,5,4,clustered,0.5;-0.15,7,8,5,2,18,-1,-6,-1,-1,-6,0,shortest
558,100,244,0.05,1,0,clustered,0.5;-0.15,5,5,5,0,0,5,0,5,5,0,0,shortest
557,100,253,0.05,4,3,clustered,0.5;-0.15,12,10,5,7,18,-1,-6,-1,-1,-6,0,shortest
556,100,223,0.05,1,0,clustered,0.5;-0.15,30,14,6,24,10,-1,-7,30,14,24,10,shortest
554,100,242,0.05,7,6,clustered,0.5;-0.15,6,6,4,2,0,6,2,6,6,2,0,shortest
553,100,233,0.05,2,1,clustered,0.5;-0.15,-1,-1,6,-7,10,-1,-7,-1,-1,-7,0,shortest
549,100,247,0.05,4,3,clustered,0.5;-0.15,-1,-1,6,-7,18,-1,-7,-1,-1,-7,0,shortest
548,100,232,0.05,5,4,clustered,0.5;-0.15,16,16,4,12,0,8,4,8,8,4,0,shortest
546,100,245,0.05,3,2,clustered,0.5;-0.15,15,15,5,10,0,-1,-6,-1,-1,-6,0,shortest
545,100,253,0.05,5,4,clustered,0.5;-0.15,-1,-1,7,-8,0,-1,-8,-1,-1,-8,0,shortest
544,100,254,0.05,1,0,clustered,0.5;-0.15,23,21,5,18,10,-1,-6,23,21,18,10,shortest
543,100,261,0.05,5,4,clustered,0.5;-0.15,6,6,4,2,0,6,2,6,6,2,0,shortest
541,100,274,0.05,2,1,clustered,0.5;-0.15,4,6,4,0,18,6,2,6,6,2,0,shortest
540,100,234,0.05,1,0,clustered,0.5;-0.15,-1,-1,6,-7,0,-1,-7,-1,-1,-7,0,shortest
539,100,269,0.05,5,4,clustered,0.5;-0.15,12,14,6,6,14,-1,-7,-1,-1,-7,0,shortest
538,100,264,0.05,11,10,clustered,0.5;-0.15,38,38,4,34,0,18,14,18,18,14,0,shortest
537,100,253,0.05,3,2,clustered,0.5;-0.15,26,26,5,21,0,-1,-6,-1,-1,-6,0,shortest
535,100,248,0.05,4,3,clustered,0.5;-0.15,-1,-1,6,-7,10,-1,-7,-1,-1,-7,0,shortest
534,100,237,0.05,6,5,clustered,0.5;-0.15,48,26,5,43,0,20,15,20,20,15,0,shortest
531,100,240,0.05,3,2,clustered,0.5;-0.15,-1,-1,6,-7,0,-1,-7,-1,-1,-7,0,shortest
530,100,218,0.05,2,1,clustered,0.5;-0.15,-1,-1,7,-8,12,-1,-8,-1,-1,-8,0,shortest
529,100,268,0.05,3,2,clustered,0.5;-0.15,13,29,5,8,0,15,10,15,15,10,0,shortest
528,100,253,0.05,4,3,clustered,0.5;-0.15,8,12,4,4,0,8,4,8,8,4,0,shortest
527,100,241,0.05,4,3,clustered,0.5;-0.15,-1,-1,6,-7,0,-1,-7,-1,-1,-7,0,shortest
526,100,228,0.05,6,5,clustered,0.5;-0.15,30,22,4,26,0,18,14,18,18,14,0,shortest
524,100,236,0.05,3,2,clustered,0.5;-0.15,8,8,4,4,0,-1,-5,-1,-1,-5,0,shortest
522,100,266,0.05,8,7,clustered,0.5;-0.15,37,35,3,34,6,-1,-4,-1,-1,-4,0,shortest
521,100,237,0.05,1,0,clustered,0.5;-0.15,10,8,6,4,16,-1,-7,10,8,4,16,shortest
520,100,261,0.05,7,6,clustered,0.5;-0.15,3,3,3,0,0,3,0,3,3,0,0,shortest
519,100,224,0.05,5,4,clustered,0.5;-0.15,7,7,3,4,0,7,4,7,7,4,0,shortest
518,100,236,0.05,4,3,clustered,0.5;-0.15,3,3,3,0,4,3,0,3,3,0,0,shortest
517,100,238,0.05,3,2,clustered,0.5;-0.15,-1,-1,4,-5,30,-1,-5,-1,-1,-5,0,shortest
515,100,266,0.05,3,2,clustered,0.5;-0.15,21,21,5,16,0,-1,-6,-1,-1,-6,0,shortest
514,100,277,0.05,5,4,clustered,0.5;-0.15,-1,-1,4,-5,0,-1,-5,-1,-1,-5,0,shortest
512,100,249,0.05,3,2,clustered,0.5;-0.15,26,48,6,20,0,14,8,14,14,8,0,shortest
511,100,255,0.05,7,6,clustered,0.5;-0.15,2,2,2,0,0,2,0,2,2,0,0,shortest
509,100,263,0.05,4,3,clustered,0.5;-0.15,36,36,4,32,0,13,9,13,13,9,0,shortest
508,100,250,0.05,3,2,clustered,0.5;-0.15,3,7,3,0,0,3,0,3,3,0,0,shortest
507,100,260,0.05,5,4,clustered,0.5;-0.15,-1,-1,5,-6,12,-1,-6,-1,-1,-6,0,shortest
506,100,237,0.05,2,1,clustered,0.5;-0.15,-1,-1,5,-6,12,-1,-6,-1,-1,-6,0,shortest
505,100,258,0.05,6,5,clustered,0.5;-0.15,-1,-1,4,-5,0,-1,-5,-1,-1,-5,0,shortest
504,100,251,0.05,4,3,clustered,0.5;-0.15,-1,-1,4,-5,20,-1,-5,-1,-1,-5,0,shortest
503,100,260,0.05,4,3,clustered,0.5;-0.15,24,24,3,21,4,11,8,11,11,8,0,shortest
502,100,254,0.05,5,4,clustered,0.5;-0.15,-1,-1,5,-6,6,-1,-6,-1,-1,-6,0,shortest
500,100,249,0.05,3,2,clustered,0.5;-0.15,13,13,5,8,0,-1,-6,-1,-1,-6,0,shortest
499,100,253,0.05,3,2,clustered,0.5;-0.15,-1,-1,7,-8,22,-1,-8,-1,-1,-8,0,shortest
498,100,244,0.05,5,4,clustered,0.5;-0.15,11,21,5,6,0,11,6,11,11,6,0,shortest
495,100,251,0.05,5,4,clustered,0.5;-0.15,24,24,4,20,10,17,13,17,17,13,0,shortest
494,100,225,0.05,3,2,clustered,0.5;-0.15,-1,-1,8,-9,6,-1,-9,-1,-1,-9,0,shortest
493,100,238,0.05,4,3,clustered,0.5;-0.15,6,6,4,2,0,8,4,8,8,4,0,shortest
492,100,254,0.05,5,4,clustered,0.5;-0.15,32,40,4,28,4,-1,-5,-1,-1,-5,0,shortest
491,100,260,0.05,5,4,clustered,0.5;-0.15,-1,-1,5,-6,0,-1,-6,-1,-1,-6,0,shortest
489,100,240,0.05,2,1,clustered,0.5;-0.15,-1,-1,5,-6,0,-1,-6,-1,-1,-6,0,shortest
488,100,242,0.05,6,5,clustered,0.5;-0.15,-1,-1,5,-6,4,-1,-6,-1,-1,-6,0,shortest
485,100,252,0.05,3,2,clustered,0.5;-0.15,-1,-1,5,-6,12,-1,-6,-1,-1,-6,0,shortest
484,100,264,0.05,4,3,clustered,0.5;-0.15,2,2,2,0,6,2,0,2,2,0,0,shortest
483,100,268,0.05,3,2,clustered,0.5;-0.15,9,9,5,4,0,-1,-6,-1,-1,-6,0,shortest
482,100,214,0.05,2,1,clustered,0.5;-0.15,25,29,5,20,6,11,6,11,11,6,0,shortest
481,100,246,0.05,3,2,clustered,0.5;-0.15,25,25,5,20,0,9,4,9,9,4,0,shortest
479,100,223,0.05,5,4,clustered,0.5;-0.15,7,7,3,4,6,7,4,7,7,4,0,shortest
478,100,247,0.05,3,2,clustered,0.5;-0.15,-1,-1,5,-6,8,-1,-6,-1,-1,-6,0,shortest
477,100,206,0.05,6,5,clustered,0.5;-0.15,28,28,4,24,0,14,10,14,14,10,0,shortest
476,100,249,0.05,3,2,clustered,0.5;-0.15,3,3,3,0,4,3,0,3,3,0,0,shortest
475,100,255,0.05,5,4,clustered,0.5;-0.15,39,37,5,34,8,-1,-6,-1,-1,-6,0,shortest
474,100,232,0.05,1,0,clustered,0.5;-0.15,-1,-1,4,-5,0,-1,-5,-1,-1,-5,0,shortest
473,100,238,0.05,3,2,clustered,0.5;-0.15,45,43,6,39,30,-1,-7,-1,-1,-7,0,shortest
471,100,241,0.05,4,3,clustered,0.5;-0.15,-1,-1,7,-8,4,-1,-8,-1,-1,-8,0,shortest
470,100,230,0.05,1,0,clustered,0.5;-0.15,7,23,5,2,18,-1,-6,7,23,2,18,shortest
469,100,270,0.05,3,2,clustered,0.5;-0.15,-1,-1,5,-6,0,-1,-6,-1,-1,-6,0,shortest
468,100,263,0.05,5,4,clustered,0.5;-0.15,-1,-1,5,-6,32,-1,-6,-1,-1,-6,0,shortest
467,100,265,0.05,3,2,clustered,0.5;-0.15,-1,-1,6,-7,4,-1,-7,-1,-1,-7,0,shortest
466,100,266,0.05,4,3,clustered,0.5;-0.15,-1,-1,8,-9,0,-1,-9,-1,-1,-9,0,shortest
465,100,251,0.05,2,1,clustered,0.5;-0.15,9,9,4,5,0,-1,-5,-1,-1,-5,0,shortest
463,100,283,0.05,3,2,clustered,0.5;-0.15,12,8,5,7,0,9,4,9,9,4,0,shortest
462,100,264,0.05,2,1,clustered,0.5;-0.15,7,5,5,2,0,-1,-6,-1,-1,-6,0,shortest
461,100,243,0.05,4,3,clustered,0.5;-0.15,14,34,4,10,0,6,2,6,6,2,0,shortest
460,100,245,0.05,3,2,clustered,0.5;-0.15,16,16,4,12,12,12,8,12,12,8,0,shortest
459,100,238,0.05,4,3,clustered,0.5;-0.15,8,8,4,4,0,8,4,8,8,4,0,shortest
458,100,241,0.05,4,3,clustered,0.5;-0.15,-1,-1,5,-6,4,-1,-6,-1,-1,-6,0,shortest
457,100,234,0.05,4,3,clustered,0.5;-0.15,14,8,5,9,0,-1,-6,-1,-1,-6,0,shortest
456,100,232,0.05,6,5,clustered,0.5;-0.15,-1,-1,6,-7,6,-1,-7,-1,-1,-7,0,shortest
455,100,262,0.05,5,4,clustered,0.5;-0.15,29,41,5,24,6,-1,-6,-1,-1,-6,0,shortest
454,100,257,0.05,4,3,clustered,0.5;-0.15,10,10,4,6,0,4,0,4,4,0,0,shortest
451,100,242,0.05,3,2,clustered,0.5;-0.15,-1,-1,7,-8,4,-1,-8,-1,-1,-8,0,shortest
449,100,226,0.05,6,5,clustered,0.5;-0.15,17,23,4,13,0,8,4,14,14,10,0,shortest
448,100,206,0.05,2,1,clustered,0.5;-0.15,3,3,3,0,8,3,0,3,3,0,0,shortest
447,100,238,0.05,8,7,clustered,0.5;-0.15,-1,-1,4,-5,8,-1,-5,-1,-1,-5,0,shortest
446,100,235,0.05,9,8,clustered,0.5;-0.15,8,8,4,4,0,8,4,8,8,4,0,shortest
445,100,228,0.05,6,5,clustered,0.5;-0.15,-1,-1,5,-6,0,-1,-6,-1,-1,-6,0,shortest
444,100,253,0.05,3,2,clustered,0.5;-0.15,7,7,5,2,0,7,2,7,7,2,0,shortest
441,100,238,0.05,5,4,clustered,0.5;-0.15,3,5,3,0,0,3,0,5,5,2,0,shortest
439,100,252,0.05,4,3,clustered,0.5;-0.15,-1,-1,6,-7,22,-1,-7,-1,-1,-7,0,shortest
437,100,250,0.05,4,3,clustered,0.5;-0.15,-1,-1,4,-5,0,-1,-5,-1,-1,-5,0,shortest
436,100,248,0.05,5,4,clustered,0.5;-0.15,22,28,4,18,0,-1,-5,-1,-1,-5,0,shortest
433,100,246,0.05,2,1,clustered,0.5;-0.15,-1,-1,6,-7,4,-1,-7,-1,-1,-7,0,shortest
432,100,223,0.05,5,4,clustered,0.5;-0.15,63,63,5,58,12,13,8,13,13,8,0,shortest
431,100,268,0.05,4,3,clustered,0.5;-0.15,13,13,3,10,30,5,2,5,5,2,0,shortest
429,100,228,0.05,2,1,clustered,0.5;-0.15,4,4,4,0,0,4,0,4,4,0,0,shortest
428,100,239,0.05,6,5,clustered,0.5;-0.15,12,18,4,8,0,-1,-5,-1,-1,-5,0,shortest
427,100,274,0.05,6,5,clustered,0.5;-0.15,48,48,4,44,0,-1,-5,-1,-1,-5,0,shortest
425,100,250,0.05,2,1,clustered,0.5;-0.15,-1,-1,5,-6,0,-1,-6,-1,-1,-6,0,shortest
424,100,260,0.05,3,2,clustered,0.5;-0.15,-1,-1,4,-5,0,-1,-5,-1,-1,-5,0,shortest
422,100,248,0.05,5,4,clustered,0.5;-0.15,-1,-1,5,-6,0,-1,-6,-1,-1,-6,0,shortest
421,100,270,0.05,5,4,clustered,0.5;-0.15,22,22,5,17,4,-1,-6,-1,-1,-6,0,shortest
420,100,256,0.05,5,4,clustered,0.5;-0.15,2,2,2,0,0,2,0,2,2,0,0,shortest
419,100,245,0.05,7,6,clustered,0.5;-0.15,23,11,6,17,0,-1,-7,-1,-1,-7,0,shortest
418,100,257,0.05,4,3,clustered,0.5;-0.15,21,11,5,16,12,-1,-6,-1,-1,-6,0,shortest
416,100,238,0.05,2,1,clustered,0.5;-0.15,10,6,5,5,12,-1,-6,-1,-1,-6,0,shortest
415,100,244,0.05,2,1,clustered,0.5;-0.15,12,6,6,6,8,-1,-7,-1,-1,-7,0,shortest
414,100,239,0.05,7,6,clustered,0.5;-0.15,9,13,4,5,4,-1,-5,-1,-1,-5,0,shortest
413,100,247,0.05,3,2,clustered,0.5;-0.15,25,25,4,21,0,11,7,11,11,7,0,shortest
412,100,251,0.05,5,4,clustered,0.5;-0.15,20,20,4,16,2,8,4,8,8,4,0,shortest
410,100,238,0.05,4,3,clustered,0.5;-0.15,10,10,4,6,10,-1,-5,-1,-1,-5,0,shortest
409,100,224,0.05,3,2,clustered,0.5;-0.15,19,15,4,15,0,-1,-5,-1,-1,-5,0,shortest
407,100,229,0.05,2,1,clustered,0.5;-0.15,-1,-1,6,-7,8,-1,-7,-1,-1,-7,0,shortest
406,100,237,0.05,3,2,clustered,0.5;-0.15,10,10,4,6,0,10,6,10,10,6,0,shortest
405,100,262,0.05,4,3,clustered,0.5;-0.15,26,34,5,21,4,-1,-6,-1,-1,-6,0,shortest
403,100,239,0.05,3,2,clustered,0.5;-0.15,6,6,4,2,14,6,2,6,6,2,0,shortest
402,100,245,0.05,2,1,clustered,0.5;-0.15,-1,-1,5,-6,0,-1,-6,-1,-1,-6,0,shortest
401,100,242,0.05,3,2,clustered,0.5;-0.15,18,18,5,13,0,-1,-6,-1,-1,-6,0,shortest
400,100,247,0.05,4,3,clustered,0.5;-0.15,22,26,4,18,4,11,7,11,11,7,0,shortest
399,100,247,0.05,4,3,clustered,0.5;-0.15,3,3,3,0,0,3,0,5,5,2,0,shortest
398,100,244,0.05,5,4,clustered,0.5;-0.15,50,38,4,46,4,-1,-5,-1,-1,-5,0,shortest
396,100,259,0.05,8,7,clustered,0.5;-0.15,-1,-1,5,-6,0,-1,-6,-1,-1,-6,0,shortest
395,100,262,0.05,5,4,clustered,0.5;-0.15,4,4,4,0,0,4,0,4,4,0,0,shortest
392,100,241,0.05,2,1,clustered,0.5;-0.15,7,5,4,3,0,-1,-5,-1,-1,-5,0,shortest
391,100,262,0.05,5,4,clustered,0.5;-0.15,-1,-1,5,-6,4,-1,-6,-1,-1,-6,0,shortest
390,100,255,0.05,2,1,clustered,0.5;-0.15,-1,-1,6,-7,0,-1,-7,-1,-1,-7,0,shortest
388,100,251,0.05,4,3,clustered,0.5;-0.15,5,21,5,0,12,5,0,5,5,0,0,shortest
387,100,248,0.05,3,2,clustered,0.5;-0.15,3,3,3,0,0,3,0,3,3,0,0,shortest
385,100,235,0.05,3,2,clustered,0.5;-0.15,-1,-1,5,-6,8,-1,-6,-1,-1,-6,0,shortest
383,100,258,0.05,3,2,clustered,0.5;-0.15,-1,-1,6,-7,16,-1,-7,-1,-1,-7,0,shortest
381,100,272,0.05,8,7,clustered,0.5;-0.15,5,5,3,2,0,5,2,5,5,2,0,shortest
380,100,246,0.05,5,4,clustered,0.5;-0.15,-1,-1,6,-7,6,-1,-7,-1,-1,-7,0,shortest
379,100,262,0.05,6,5,clustered,0.5;-0.15,-1,-1,5,-6,0,-1,-6,-1,-1,-6,0,shortest
378,100,226,0.05,4,3,clustered,0.5;-0.15,6,18,4,2,0,6,2,10,10,6,0,shortest
377,100,260,0.05,6,5,clustered,0.5;-0.15,45,55,5,40,2,-1,-6,-1,-1,-6,0,shortest
376,100,251,0.05,3,2,clustered,0.5;-0.15,-1,-1,6,-7,24,-1,-7,-1,-1,-7,0,shortest
375,100,227,0.05,3,2,clustered,0.5;-0.15,19,29,5,14,0,13,8,13,13,8,0,shortest
374,100,247,0.05,5,4,clustered,0.5;-0.15,9,9,6,3,0,-1,-7,-1,-1,-7,0,shortest
372,100,261,0.05,8,7,clustered,0.5;-0.15,45,42,4,41,0,-1,-5,-1,-1,-5,0,shortest
369,100,285,0.05,3,2,clustered,0.5;-0.15,4,8,4,0,0,4,0,4,4,0,0,shortest
367,100,260,0.05,4,3,clustered,0.5;-0.15,26,26,5,21,4,-1,-6,-1,-1,-6,0,shortest
365,100,245,0.05,4,3,clustered,0.5;-0.15,4,8,4,0,8,4,0,4,4,0,0,shortest
364,100,247,0.05,3,2,clustered,0.5;-0.15,3,3,3,0,0,3,0,3,3,0,0,shortest
362,100,237,0.05,2,1,clustered,0.5;-0.15,-1,-1,5,-6,4,-1,-6,-1,-1,-6,0,shortest
361,100,266,0.05,5,4,clustered,0.5;-0.15,13,21,5,8,0,-1,-6,-1,-1,-6,0,shortest
360,100,250,0.05,2,1,clustered,0.5;-0.15,-1,-1,7,-8,8,-1,-8,-1,-1,-8,0,shortest
359,100,277,0.05,5,4,clustered,0.5;-0.15,2,2,2,0,16,2,0,2,2,0,0,shortest
358,100,232,0.05,5,4,clustered,0.5;-0.15,59,59,5,54,0,19,14,19,19,14,0,shortest
356,100,260,0.05,4,3,clustered,0.5;-0.15,17,17,5,12,12,-1,-6,-1,-1,-6,0,shortest
355,100,268,0.05,8,7,clustered,0.5;-0.15,30,42,4,26,0,10,6,16,16,12,0,shortest
354,100,242,0.05,8,7,clustered,0.5;-0.15,24,24,4,20,0,18,14,18,18,14,0,shortest
352,100,245,0.05,3,2,clustered,0.5;-0.15,3,9,3,0,0,3,0,3,3,0,0,shortest
351,100,246,0.05,6,5,clustered,0.5;-0.15,-1,-1,4,-5,0,-1,-5,-1,-1,-5,0,shortest
350,100,261,0.05,4,3,clustered,0.5;-0.15,18,18,4,14,0,-1,-5,-1,-1,-5,0,shortest
349,100,231,0.05,3,2,clustered,0.5;-0.15,3,3,3,0,8,3,0,3,3,0,0,shortest
348,100,252,0.05,3,2,clustered,0.5;-0.15,-1,-1,5,-6,16,-1,-6,-1,-1,-6,0,shortest
347,100,216,0.05,1,0,clustered,0.5;-0.15,-1,-1,6,-7,0,-1,-7,-1,-1,-7,0,shortest
345,100,281,0.05,6,5,clustered,0.5;-0.15,11,5,4,7,0,19,15,19,19,15,0,shortest
344,100,267,0.05,6,5,clustered,0.5;-0.15,57,57,5,52,10,19,14,19,19,14,0,shortest
343,100,254,0.05,6,5,clustered,0.5;-0.15,2,2,2,0,0,2,0,2,2,0,0,shortest
342,100,264,0.05,3,2,clustered,0.5;-0.15,3,3,3,0,22,7,4,7,7,4,0,shortest
340,100,219,0.05,4,3,clustered,0.5;-0.15,17,17,3,14,0,3,0,3,3,0,0,shortest
338,100,226,0.05,2,1,clustered,0.5;-0.15,8,8,4,4,0,8,4,8,8,4,0,shortest
335,100,231,0.05,4,3,clustered,0.5;-0.15,27,33,5,22,4,-1,-6,-1,-1,-6,0,shortest
334,100,250,0.05,3,2,clustered,0.5;-0.15,51,49,4,47,0,-1,-5,-1,-1,-5,0,shortest
333,100,247,0.05,4,3,clustered,0.5;-0.15,21,21,3,18,10,5,2,5,5,2,0,shortest
330,100,267,0.05,6,5,clustered,0.5;-0.15,-1,-1,6,-7,0,-1,-7,-1,-1,-7,0,shortest
329,100,258,0.05,5,4,clustered,0.5;-0.15,-1,-1,6,-7,12,-1,-7,-1,-1,-7,0,shortest
328,100,243,0.05,3,2,clustered,0.5;-0.15,-1,-1,6,-7,0,-1,-7,-1,-1,-7,0,shortest
326,100,245,0.05,4,3,clustered,0.5;-0.15,37,37,5,32,0,15,10,15,15,10,0,shortest
325,100,255,0.05,4,3,clustered,0.5;-0.15,-1,-1,4,-5,8,-1,-5,-1,-1,-5,0,shortest
323,100,247,0.05,5,4,clustered,0.5;-0.15,-1,-1,5,-6,4,-1,-6,-1,-1,-6,0,shortest
322,100,249,0.05,4,3,clustered,0.5;-0.15,4,4,4,0,4,10,6,4,4,0,2,shortest
321,100,245,0.05,4,3,clustered,0.5;-0.15,-1,-1,6,-7,12,-1,-7,-1,-1,-7,0,shortest
320,100,239,0.05,4,3,clustered,0.5;-0.15,29,25,5,24,0,11,6,11,11,6,0,shortest
319,100,252,0.05,3,2,clustered,0.5;-0.15,35,35,5,30,0,13,8,13,13,8,0,shortest
318,100,249,0.05,3,2,clustered,0.5;-0.15,-1,-1,5,-6,0,-1,-6,-1,-1,-6,0,shortest
317,100,242,0.05,3,2,clustered,0.5;-0.15,-1,-1,6,-7,6,-1,-7,-1,-1,-7,0,shortest
316,100,243,0.05,4,3,clustered,0.5;-0.15,30,30,6,24,10,-1,-7,-1,-1,-7,0,shortest
314,100,265,0.05,4,3,clustered,0.5;-0.15,4,4,4,0,0,4,0,4,4,0,0,shortest
313,100,238,0.05,2,1,clustered,0.5;-0.15,10,6,6,4,0,-1,-7,-1,-1,-7,0,shortest
312,100,259,0.05,5,4,clustered,0.5;-0.15,-1,-1,5,-6,6,-1,-6,-1,-1,-6,0,shortest
310,100,227,0.05,10,9,clustered,0.5;-0.15,2,2,2,0,8,2,0,2,2,0,0,shortest
309,100,233,0.05,5,4,clustered,0.5;-0.15,3,3,3,0,4,3,0,3,3,0,0,shortest
307,100,246,0.05,3,2,clustered,0.5;-0.15,3,9,3,0,24,3,0,3,3,0,0,shortest
305,100,229,0.05,5,4,clustered,0.5;-0.15,6,8,4,2,0,6,2,6,6,2,0,shortest
304,100,233,0.05,4,3,clustered,0.5;-0.15,21,9,5,16,14,-1,-6,-1,-1,-6,0,shortest
303,100,260,0.05,4,3,clustered,0.5;-0.15,-1,-1,5,-6,12,-1,-6,-1,-1,-6,0,shortest
301,100,245,0.05,5,4,clustered,0.5;-0.15,36,28,4,32,0,-1,-5,-1,-1,-5,0,shortest
300,100,248,0.05,2,1,clustered,0.5;-0.15,-1,-1,5,-6,4,-1,-6,-1,-1,-6,0,shortest
299,100,252,0.05,2,1,clustered,0.5;-0.15,-1,-1,5,-6,4,-1,-6,-1,-1,-6,0,shortest
297,100,240,0.05,6,5,clustered,0.5;-0.15,-1,-1,5,-6,24,-1,-6,-1,-1,-6,0,shortest
296,100,248,0.05,6,5,clustered,0.5;-0.15,39,21,6,33,0,-1,-7,-1,-1,-7,0,shortest
295,100,274,0.05,4,3,clustered,0.5;-0.15,-1,-1,5,-6,0,-1,-6,-1,-1,-6,0,shortest
294,100,272,0.05,1,0,clustered,0.5;-0.15,-1,-1,4,-5,0,-1,-5,-1,-1,-5,0,shortest
293,100,264,0.05,5,4,clustered,0.5;-0.15,10,10,4,6,8,-1,-5,-1,-1,-5,0,shortest
292,100,245,0.05,4,3,clustered,0.5;-0.15,-1,-1,6,-7,0,-1,-7,-1,-1,-7,0,shortest
291,100,260,0.05,4,3,clustered,0.5;-0.15,-1,-1,5,-6,16,-1,-6,-1,-1,-6,0,shortest
290,100,240,0.05,2,1,clustered,0.5;-0.15,16,10,5,11,12,-1,-6,-1,-1,-6,0,shortest
288,100,240,0.05,2,1,clustered,0.5;-0.15,-1,-1,6,-7,12,-1,-7,-1,-1,-7,0,shortest
287,100,256,0.05,4,3,clustered,0.5;-0.15,20,14,6,14,0,-1,-7,-1,-1,-7,0,shortest
285,100,225,0.05,2,1,clustered,0.5;-0.15,16,16,5,11,0,8,3,8,8,3,0,shortest
284,100,253,0.05,6,5,clustered,0.5;-0.15,3,3,3,0,2,3,0,7,7,4,0,shortest
283,100,238,0.05,3,2,clustered,0.5;-0.15,-1,-1,5,-6,26,-1,-6,-1,-1,-6,0,shortest
281,100,230,0.05,2,1,clustered,0.5;-0.15,9,9,4,5,0,-1,-5,-1,-1,-5,0,shortest
280,100,225,0.05,2,1,clustered,0.5;-0.15,30,30,6,24,12,-1,-7,-1,-1,-7,0,shortest
278,100,264,0.05,5,4,clustered,0.5;-0.15,-1,-1,4,-5,0,-1,-5,-1,-1,-5,0,shortest
276,100,245,0.05,6,5,clustered,0.5;-0.15,3,3,3,0,10,5,2,3,3,0,0,shortest
275,100,241,0.05,4,3,clustered,0.5;-0.15,-1,-1,4,-5,14,-1,-5,-1,-1,-5,0,shortest
273,100,248,0.05,4,3,clustered,0.5;-0.15,21,31,5,16,4,11,6,11,11,6,0,shortest
271,100,275,0.05,5,4,clustered,0.5;-0.15,10,28,4,6,32,-1,-5,-1,-1,-5,0,shortest
270,100,246,0.05,6,5,clustered,0.5;-0.15,2,2,2,0,0,2,0,2,2,0,0,shortest
269,100,260,0.05,1,0,clustered,0.5;-0.15,8,6,6,2,12,-1,-7,8,6,2,12,shortest
268,100,242,0.05,2,1,clustered,0.5;-0.15,3,9,3,0,34,3,0,3,3,0,0,shortest
267,100,237,0.05,2,1,clustered,0.5;-0.15,-1,-1,5,-6,16,-1,-6,-1,-1,-6,0,shortest
266,100,248,0.05,3,2,clustered,0.5;-0.15,9,15,5,4,0,-1,-6,-1,-1,-6,0,shortest
264,100,255,0.05,6,5,clustered,0.5;-0.15,48,48,4,44,0,14,10,14,14,10,0,shortest
263,100,227,0.05,3,2,clustered,0.5;-0.15,14,16,4,10,8,6,2,6,6,2,0,shortest
262,100,235,0.05,4,3,clustered,0.5;-0.15,30,30,6,24,0,-1,-7,-1,-1,-7,0,shortest
260,100,259,0.05,3,2,clustered,0.5;-0.15,-1,-1,4,-5,0,-1,-5,-1,-1,-5,0,shortest
258,100,250,0.05,2,1,clustered,0.5;-0.15,12,12,5,7,24,-1,-6,-1,-1,-6,0,shortest
257,100,241,0.05,4,3,clustered,0.5;-0.15,13,13,5,8,10,-1,-6,-1,-1,-6,0,shortest
256,100,243,0.05,4,3,clustered,0.5;-0.15,-1,-1,4,-5,0,-1,-5,-1,-1,-5,0,shortest
255,100,244,0.05,3,2,clustered,0.5;-0.15,-1,-1,5,-6,0,-1,-6,-1,-1,-6,0,shortest
254,100,255,0.05,2,1,clustered,0.5;-0.15,-1,-1,7,-8,8,-1,-8,-1,-1,-8,0,shortest
253,100,242,0.05,2,1,clustered,0.5;-0.15,-1,-1,5,-6,0,-1,-6,-1,-1,-6,0,shortest
251,100,228,0.05,4,3,clustered,0.5;-0.15,3,3,3,0,0,3,0,3,3,0,0,shortest
250,100,298,0.05,5,4,clustered,0.5;-0.15,-1,-1,6,-7,0,-1,-7,-1,-1,-7,0,shortest
248,100,248,0.05,5,4,clustered,0.5;-0.15,-1,-1,5,-6,0,-1,-6,-1,-1,-6,0,shortest
247,100,246,0.05,6,5,clustered,0.5;-0.15,-1,-1,5,-6,0,-1,-6,-1,-1,-6,0,shortest
246,100,245,0.05,4,3,clustered,0.5;-0.15,3,3,3,0,2,3,0,3,3,0,0,shortest
245,100,244,0.05,5,4,clustered,0.5;-0.15,11,17,4,7,0,-1,-5,-1,-1,-5,0,shortest
243,100,258,0.05,1,0,clustered,0.5;-0.15,-1,-1,5,-6,0,-1,-6,-1,-1,-6,0,shortest
242,100,244,0.05,3,2,clustered,0.5;-0.15,11,7,5,6,4,-1,-6,-1,-1,-6,0,shortest
241,100,220,0.05,2,1,clustered,0.5;-0.15,-1,-1,5,-6,0,-1,-6,-1,-1,-6,0,shortest
240,100,223,0.05,5,4,clustered,0.5;-0.15,29,29,6,23,0,-1,-7,-1,-1,-7,0,shortest
239,100,248,0.05,1,0,clustered,0.5;-0.15,3,3,3,0,0,3,0,3,3,0,0,shortest
238,100,269,0.05,4,3,clustered,0.5;-0.15,10,10,4,6,0,8,4,8,8,4,0,shortest
237,100,248,0.05,3,2,clustered,0.5;-0.15,-1,-1,8,-9,4,-1,-9,-1,-1,-9,0,shortest
236,100,278,0.05,6,5,clustered,0.5;-0.15,2,2,2,0,16,2,0,2,2,0,0,shortest
235,100,239,0.05,2,1,clustered,0.5;-0.15,-1,-1,5,-6,26,-1,-6,-1,-1,-6,0,shortest
233,100,271,0.05,3,2,clustered,0.5;-0.15,-1,-1,5,-6,0,-1,-6,-1,-1,-6,0,shortest
232,100,261,0.05,3,2,clustered,0.5;-0.15,9,9,6,3,0,-1,-7,-1,-1,-7,0,shortest
231,100,247,0.05,1,0,clustered,0.5;-0.15,2,2,2,0,0,2,0,2,2,0,0,shortest
228,100,243,0.05,5,4,clustered,0.5;-0.15,29,25,4,25,8,-1,-5,-1,-1,-5,0,shortest
227,100,241,0.05,4,3,clustered,0.5;-0.15,4,4,4,0,8,4,0,4,4,0,0,shortest
226,100,257,0.05,5,4,clustered,0.5;-0.15,-1,-1,5,-6,0,-1,-6,-1,-1,-6,0,shortest
225,100,259,0.05,3,2,clustered,0.5;-0.15,14,12,4,10,4,8,4,8,8,4,0,shortest
224,100,257,0.05,5,4,clustered,0.5;-0.15,7,7,3,4,0,7,4,7,7,4,0,shortest
222,100,264,0.05,5,4,clustered,0.5;-0.15,7,7,3,4,8,5,2,5,5,2,0,shortest
221,100,264,0.05,4,3,clustered,0.5;-0.15,-1,-1,6,-7,8,-1,-7,-1,-1,-7,0,shortest
220,100,289,0.05,6,5,clustered,0.5;-0.15,-1,-1,6,-7,12,-1,-7,-1,-1,-7,0,shortest
219,100,268,0.05,4,3,clustered,0.5;-0.15,-1,-1,6,-7,0,-1,-7,-1,-1,-7,0,shortest
218,100,235,0.05,4,3,clustered,0.5;-0.15,-1,-1,5,-6,0,-1,-6,-1,-1,-6,0,shortest
217,100,279,0.05,7,6,clustered,0.5;-0.15,24,14,5,19,6,-1,-6,-1,-1,-6,0,shortest
216,100,258,0.05,6,5,clustered,0.5;-0.15,-1,-1,6,-7,0,-1,-7,-1,-1,-7,0,shortest
215,100,257,0.05,3,2,clustered,0.5;-0.15,-1,-1,5,-6,0,-1,-6,-1,-1,-6,0,shortest
214,100,252,0.05,5,4,clustered,0.5;-0.15,31,31,5,26,0,-1,-6,-1,-1,-6,0,shortest
213,100,258,0.05,4,3,clustered,0.5;-0.15,2,2,2,0,0,2,0,2,2,0,0,shortest
211,100,245,0.05,3,2,clustered,0.5;-0.15,7,9,4,3,6,6,2,6,6,2,0,shortest
210,100,235,0.05,1,0,clustered,0.5;-0.15,-1,-1,6,-7,0,-1,-7,-1,-1,-7,0,shortest
209,100,233,0.05,6,5,clustered,0.5;-0.15,16,16,5,11,0,19,14,19,19,14,0,shortest
208,100,242,0.05,4,3,clustered,0.5;-0.15,-1,-1,5,-6,0,-1,-6,-1,-1,-6,0,shortest
207,100,262,0.05,8,7,clustered,0.5;-0.15,3,3,3,0,0,3,0,3,3,0,0,shortest
206,100,234,0.05,3,2,clustered,0.5;-0.15,3,3,3,0,0,3,0,3,3,0,0,shortest
205,100,245,0.05,3,2,clustered,0.5;-0.15,-1,-1,5,-6,0,-1,-6,-1,-1,-6,0,shortest
204,100,259,0.05,2,1,clustered,0.5;-0.15,4,4,4,0,8,-1,-5,-1,-1,-5,0,shortest
203,100,279,0.05,5,4,clustered,0.5;-0.15,4,4,4,0,24,8,4,6,6,2,10,shortest
202,100,242,0.05,5,4,clustered,0.5;-0.15,26,34,6,20,0,-1,-7,-1,-1,-7,0,shortest
201,100,218,0.05,4,3,clustered,0.5;-0.15,6,6,5,1,0,12,7,12,12,7,0,shortest
200,100,251,0.05,4,3,clustered,0.5;-0.15,12,12,4,8,0,4,0,8,8,4,0,shortest
199,100,255,0.05,4,3,clustered,0.5;-0.15,45,51,5,40,0,7,2,7,7,2,0,shortest
198,100,294,0.05,3,2,clustered,0.5;-0.15,3,5,3,0,18,3,0,3,3,0,0,shortest
196,100,239,0.05,5,4,clustered,0.5;-0.15,35,29,5,30,0,-1,-6,-1,-1,-6,0,shortest
193,100,237,0.05,4,3,clustered,0.5;-0.15,38,34,6,32,0,-1,-7,-1,-1,-7,0,shortest
192,100,230,0.05,3,2,clustered,0.5;-0.15,31,45,7,24,16,-1,-8,-1,-1,-8,0,shortest
188,100,253,0.05,3,2,clustered,0.5;-0.15,-1,-1,6,-7,0,-1,-7,-1,-1,-7,0,shortest
187,100,230,0.05,4,3,clustered,0.5;-0.15,-1,-1,6,-7,0,-1,-7,-1,-1,-7,0,shortest
184,100,223,0.05,4,3,clustered,0.5;-0.15,13,9,4,9,8,-1,-5,-1,-1,-5,0,shortest
183,100,293,0.05,4,3,clustered,0.5;-0.15,44,44,2,42,12,2,0,2,2,0,0,shortest
182,100,240,0.05,1,0,clustered,0.5;-0.15,4,4,4,0,4,4,0,4,4,0,4,shortest
181,100,240,0.05,5,4,clustered,0.5;-0.15,18,18,4,14,0,14,10,14,14,10,0,shortest
180,100,247,0.05,5,4,clustered,0.5;-0.15,3,3,3,0,4,3,0,3,3,0,0,shortest
179,100,256,0.05,5,4,clustered,0.5;-0.15,38,36,5,33,12,-1,-6,-1,-1,-6,0,shortest
177,100,257,0.05,4,3,clustered,0.5;-0.15,3,9,3,0,0,3,0,3,3,0,0,shortest
176,100,224,0.05,3,2,clustered,0.5;-0.15,26,24,6,20,0,-1,-7,-1,-1,-7,0,shortest
175,100,256,0.05,4,3,clustered,0.5;-0.15,5,13,4,1,16,4,0,6,6,2,0,shortest
174,100,258,0.05,6,5,clustered,0.5;-0.15,39,39,5,34,4,11,6,11,11,6,0,shortest
173,100,228,0.05,3,2,clustered,0.5;-0.15,7,7,3,4,2,3,0,7,7,4,0,shortest
171,100,242,0.05,5,4,clustered,0.5;-0.15,-1,-1,5,-6,8,-1,-6,-1,-1,-6,0,shortest
169,100,239,0.05,6,5,clustered,0.5;-0.15,-1,-1,8,-9,4,-1,-9,-1,-1,-9,0,shortest
168,100,225,0.05,2,1,clustered,0.5;-0.15,18,16,6,12,0,-1,-7,-1,-1,-7,0,shortest
167,100,266,0.05,4,3,clustered,0.5;-0.15,33,35,5,28,14,-1,-6,-1,-1,-6,0,shortest
165,100,244,0.05,3,2,clustered,0.5;-0.15,17,23,4,13,0,-1,-5,-1,-1,-5,0,shortest
164,100,246,0.05,2,1,clustered,0.5;-0.15,3,17,3,0,24,3,0,3,3,0,0,shortest
162,100,267,0.05,2,1,clustered,0.5;-0.15,3,3,3,0,0,3,0,3,3,0,0,shortest
161,100,244,0.05,2,1,clustered,0.5;-0.15,4,10,4,0,0,6,2,6,6,2,0,shortest
160,100,222,0.05,3,2,clustered,0.5;-0.15,-1,-1,4,-5,0,-1,-5,-1,-1,-5,0,shortest
159,100,220,0.05,3,2,clustered,0.5;-0.15,-1,-1,5,-6,20,-1,-6,-1,-1,-6,0,shortest
157,100,241,0.05,4,3,clustered,0.5;-0.15,26,26,6,20,0,12,6,12,12,6,0,shortest
156,100,236,0.05,4,3,clustered,0.5;-0.15,18,18,4,14,0,10,6,4,4,0,0,shortest
155,100,234,0.05,2,1,clustered,0.5;-0.15,15,17,5,10,4,-1,-6,-1,-1,-6,0,shortest
151,100,272,0.05,5,4,clustered,0.5;-0.15,62,58,6,56,0,-1,-7,-1,-1,-7,0,shortest
150,100,271,0.05,2,1,clustered,0.5;-0.15,-1,-1,4,-5,0,-1,-5,-1,-1,-5,0,shortest
149,100,258,0.05,4,3,clustered,0.5;-0.15,27,13,5,22,0,-1,-6,-1,-1,-6,0,shortest
147,100,245,0.05,7,6,clustered,0.5;-0.15,32,46,4,28,14,-1,-5,-1,-1,-5,0,shortest
146,100,221,0.05,3,2,clustered,0.5;-0.15,15,15,5,10,12,-1,-6,-1,-1,-6,0,shortest
144,100,261,0.05,3,2,clustered,0.5;-0.15,14,14,4,10,0,-1,-5,-1,-1,-5,0,shortest
143,100,249,0.05,2,1,clustered,0.5;-0.15,25,37,5,20,12,9,4,9,9,4,0,shortest
142,100,261,0.05,3,2,clustered,0.5;-0.15,3,3,3,0,32,3,0,3,3,0,0,shortest
141,100,228,0.05,7,6,clustered,0.5;-0.15,-1,-1,6,-7,8,-1,-7,-1,-1,-7,0,shortest
140,100,248,0.05,5,4,clustered,0.5;-0.15,-1,-1,6,-7,0,-1,-7,-1,-1,-7,0,shortest
139,100,231,0.05,3,2,clustered,0.5;-0.15,4,4,4,0,0,4,0,4,4,0,0,shortest
137,100,221,0.05,4,3,clustered,0.5;-0.15,-1,-1,5,-6,4,-1,-6,-1,-1,-6,0,shortest
135,100,255,0.05,5,4,clustered,0.5;-0.15,48,36,4,44,6,-1,-5,-1,-1,-5,0,shortest
133,100,246,0.05,2,1,clustered,0.5;-0.15,21,17,5,16,16,-1,-6,-1,-1,-6,0,shortest
132,100,257,0.05,3,2,clustered,0.5;-0.15,4,4,4,0,10,8,4,4,4,0,0,shortest
131,100,225,0.05,5,4,clustered,0.5;-0.15,-1,-1,4,-5,8,-1,-5,-1,-1,-5,0,shortest
130,100,230,0.05,5,4,clustered,0.5;-0.15,30,40,5,25,0,13,8,13,13,8,0,shortest
129,100,237,0.05,4,3,clustered,0.5;-0.15,12,12,4,8,16,12,8,12,12,8,0,shortest
128,100,246,0.05,2,1,clustered,0.5;-0.15,-1,-1,5,-6,0,-1,-6,-1,-1,-6,0,shortest
127,100,226,0.05,4,3,clustered,0.5;-0.15,11,19,5,6,0,7,2,7,7,2,0,shortest
125,100,273,0.05,3,2,clustered,0.5;-0.15,6,8,4,2,0,8,4,8,8,4,0,shortest
124,100,241,0.05,1,0,clustered,0.5;-0.15,6,6,4,2,10,-1,-5,6,6,2,10,shortest
123,100,237,0.05,4,3,clustered,0.5;-0.15,-1,-1,7,-8,20,-1,-8,-1,-1,-8,0,shortest
122,100,261,0.05,10,9,clustered,0.5;-0.15,-1,-1,4,-5,0,-1,-5,-1,-1,-5,0,shortest
120,100,235,0.05,5,4,clustered,0.5;-0.15,-1,-1,6,-7,26,-1,-7,-1,-1,-7,0,shortest
119,100,239,0.05,4,3,clustered,0.5;-0.15,8,8,4,4,0,4,0,8,8,4,0,shortest
118,100,274,0.05,5,4,clustered,0.5;-0.15,16,10,4,12,0,-1,-5,-1,-1,-5,0,shortest
117,100,254,0.05,2,1,clustered,0.5;-0.15,4,4,4,0,0,8,4,8,8,4,0,shortest
116,100,254,0.05,6,5,clustered,0.5;-0.15,5,5,3,2,0,5,2,5,5,2,0,shortest
115,100,271,0.05,6,5,clustered,0.5;-0.15,15,13,3,12,4,19,16,19,19,16,0,shortest
114,100,244,0.05,4,3,clustered,0.5;-0.15,3,3,3,0,36,-1,-4,-1,-1,-4,0,shortest
113,100,232,0.05,3,2,clustered,0.5;-0.15,6,6,5,1,24,-1,-6,-1,-1,-6,0,shortest
112,100,307,0.05,7,6,clustered,0.5;-0.15,16,20,4,12,0,-1,-5,-1,-1,-5,0,shortest
111,100,265,0.05,7,6,clustered,0.5;-0.15,38,38,5,33,0,12,7,12,12,7,0,shortest
110,100,244,0.05,3,2,clustered,0.5;-0.15,10,10,4,6,8,10,6,10,10,6,0,shortest
109,100,219,0.05,6,5,clustered,0.5;-0.15,43,45,4,39,0,37,33,37,37,33,0,shortest
108,100,264,0.05,4,3,clustered,0.5;-0.15,-1,-1,5,-6,0,-1,-6,-1,-1,-6,0,shortest
107,100,231,0.05,6,5,clustered,0.5;-0.15,12,10,6,6,0,20,14,20,20,14,0,shortest
106,100,243,0.05,2,1,clustered,0.5;-0.15,18,24,4,14,20,-1,-5,-1,-1,-5,0,shortest
104,100,257,0.05,2,1,clustered,0.5;-0.15,4,4,4,0,8,4,0,4,4,0,0,shortest
102,100,238,0.05,3,2,clustered,0.5;-0.15,6,6,4,2,14,6,2,6,6,2,0,shortest
101,100,251,0.05,5,4,clustered,0.5;-0.15,8,18,5,3,0,-1,-6,-1,-1,-6,0,shortest
99,100,230,0.05,5,4,clustered,0.5;-0.15,20,20,4,16,0,8,4,12,12,8,0,shortest
98,100,272,0.05,7,6,clustered,0.5;-0.15,-1,-1,4,-5,0,-1,-5,-1,-1,-5,0,shortest
96,100,233,0.05,5,4,clustered,0.5;-0.15,3,3,3,0,0,3,0,3,3,0,0,shortest
94,100,217,0.05,3,2,clustered,0.5;-0.15,4,4,4,0,0,4,0,4,4,0,0,shortest
93,100,244,0.05,3,2,clustered,0.5;-0.15,8,8,4,4,0,-1,-5,-1,-1,-5,0,shortest
91,100,254,0.05,3,2,clustered,0.5;-0.15,-1,-1,5,-6,0,-1,-6,-1,-1,-6,0,shortest
90,100,248,0.05,3,2,clustered,0.5;-0.15,12,12,4,8,0,10,6,10,10,6,0,shortest
88,100,266,0.05,5,4,clustered,0.5;-0.15,3,3,3,0,0,3,0,3,3,0,0,shortest
87,100,233,0.05,4,3,clustered,0.5;-0.15,-1,-1,4,-5,0,-1,-5,-1,-1,-5,0,shortest
86,100,229,0.05,6,5,clustered,0.5;-0.15,-1,-1,6,-7,0,-1,-7,-1,-1,-7,0,shortest
85,100,264,0.05,4,3,clustered,0.5;-0.15,21,21,3,18,20,8,5,8,8,5,0,shortest
82,100,248,0.05,5,4,clustered,0.5;-0.15,10,10,4,6,0,10,6,8,8,4,0,shortest
81,100,270,0.05,4,3,clustered,0.5;-0.15,-1,-1,5,-6,20,-1,-6,-1,-1,-6,0,shortest
80,100,242,0.05,3,2,clustered,0.5;-0.15,17,20,5,12,16,-1,-6,-1,-1,-6,0,shortest
78,100,275,0.05,2,1,clustered,0.5;-0.15,-1,-1,5,-6,24,-1,-6,-1,-1,-6,0,shortest
77,100,226,0.05,3,2,clustered,0.5;-0.15,17,17,5,12,8,-1,-6,-1,-1,-6,0,shortest
76,100,256,0.05,8,7,clustered,0.5;-0.15,7,7,3,4,4,5,2,7,7,4,0,shortest
75,100,279,0.05,6,5,clustered,0.5;-0.15,20,26,5,15,6,17,12,17,17,12,0,shortest
72,100,241,0.05,5,4,clustered,0.5;-0.15,40,40,5,35,10,24,19,24,24,19,0,shortest
71,100,256,0.05,4,3,clustered,0.5;-0.15,-1,-1,5,-6,6,-1,-6,-1,-1,-6,0,shortest
70,100,254,0.05,2,1,clustered,0.5;-0.15,9,7,4,5,20,10,6,10,10,6,0,shortest
67,100,250,0.05,2,1,clustered,0.5;-0.15,-1,-1,5,-6,0,-1,-6,-1,-1,-6,0,shortest
66,100,253,0.05,3,2,clustered,0.5;-0.15,12,12,4,8,0,8,4,8,8,4,0,shortest
64,100,244,0.05,3,2,clustered,0.5;-0.15,13,17,5,8,0,-1,-6,-1,-1,-6,0,shortest
62,100,243,0.05,3,2,clustered,0.5;-0.15,-1,-1,5,-6,0,-1,-6,-1,-1,-6,0,shortest
61,100,243,0.05,3,2,clustered,0.5;-0.15,5,5,5,0,0,5,0,5,5,0,0,shortest
60,100,260,0.05,3,2,clustered,0.5;-0.15,25,25,5,20,0,17,12,17,17,12,0,shortest
59,100,259,0.05,2,1,clustered,0.5;-0.15,3,7,3,0,0,3,0,3,3,0,0,shortest
58,100,254,0.05,5,4,clustered,0.5;-0.15,-1,-1,4,-5,6,-1,-5,-1,-1,-5,0,shortest
57,100,251,0.05,5,4,clustered,0.5;-0.15,5,5,3,2,10,3,0,5,5,2,4,shortest
56,100,237,0.05,6,5,clustered,0.5;-0.15,-1,-1,5,-6,0,-1,-6,-1,-1,-6,0,shortest
55,100,246,0.05,4,3,clustered,0.5;-0.15,18,18,6,12,0,-1,-7,-1,-1,-7,0,shortest
53,100,272,0.05,5,4,clustered,0.5;-0.15,28,28,4,24,0,12,8,8,8,4,0,shortest
52,100,227,0.05,7,6,clustered,0.5;-0.15,2,2,2,0,0,2,0,2,2,0,0,shortest
51,100,282,0.05,4,3,clustered,0.5;-0.15,24,24,4,20,12,8,4,8,8,4,0,shortest
50,100,267,0.05,6,5,clustered,0.5;-0.15,15,15,5,10,0,15,10,15,15,10,0,shortest
48,100,268,0.05,4,3,clustered,0.5;-0.15,21,27,4,17,0,-1,-5,-1,-1,-5,0,shortest
47,100,246,0.05,4,3,clustered,0.5;-0.15,14,8,5,9,0,11,6,11,11,6,0,shortest
44,100,242,0.05,3,2,clustered,0.5;-0.15,4,20,4,0,24,-1,-5,-1,-1,-5,0,shortest
40,100,260,0.05,4,3,clustered,0.5;-0.15,3,3,3,0,4,3,0,3,3,0,0,shortest
38,100,240,0.05,4,3,clustered,0.5;-0.15,-1,-1,5,-6,20,-1,-6,-1,-1,-6,0,shortest
36,100,239,0.05,4,3,clustered,0.5;-0.15,24,42,4,20,12,8,4,12,12,8,0,shortest
35,100,242,0.05,2,1,clustered,0.5;-0.15,3,3,3,0,4,3,0,3,3,0,0,shortest
34,100,231,0.05,2,1,clustered,0.5;-0.15,21,21,5,16,4,-1,-6,-1,-1,-6,0,shortest
33,100,275,0.05,2,1,clustered,0.5;-0.15,-1,-1,5,-6,0,-1,-6,-1,-1,-6,0,shortest
32,100,247,0.05,2,1,clustered,0.5;-0.15,57,57,5,52,16,-1,-6,-1,-1,-6,0,shortest
31,100,250,0.05,3,2,clustered,0.5;-0.15,-1,-1,5,-6,18,-1,-6,-1,-1,-6,0,shortest
30,100,250,0.05,3,2,clustered,0.5;-0.15,-1,-1,6,-7,10,-1,-7,-1,-1,-7,0,shortest
29,100,265,0.05,7,6,clustered,0.5;-0.15,16,16,4,12,0,16,12,16,16,12,0,shortest
28,100,220,0.05,2,1,clustered,0.5;-0.15,-1,-1,6,-7,0,-1,-7,-1,-1,-7,0,shortest
25,100,247,0.05,3,2,clustered,0.5;-0.15,29,37,5,24,20,-1,-6,-1,-1,-6,0,shortest
24,100,249,0.05,3,2,clustered,0.5;-0.15,-1,-1,6,-7,18,-1,-7,-1,-1,-7,0,shortest
21,100,230,0.05,4,3,clustered,0.5;-0.15,29,31,5,24,6,-1,-6,-1,-1,-6,0,shortest
20,100,266,0.05,4,3,clustered,0.5;-0.15,5,17,5,0,4,-1,-6,-1,-1,-6,0,shortest
19,100,250,0.05,3,2,clustered,0.5;-0.15,3,3,3,0,0,3,0,3,3,0,0,shortest
17,100,239,0.05,6,5,clustered,0.5;-0.15,-1,-1,5,-6,0,-1,-6,-1,-1,-6,0,shortest
16,100,225,0.05,2,1,clustered,0.5;-0.15,-1,-1,7,-8,4,-1,-8,-1,-1,-8,0,shortest
15,100,288,0.05,5,4,clustered,0.5;-0.15,40,38,5,35,0,-1,-6,-1,-1,-6,0,shortest
13,100,253,0.05,3,2,clustered,0.5;-0.15,23,23,5,18,0,5,0,5,5,0,0,shortest
12,100,233,0.05,4,3,clustered,0.5;-0.15,-1,-1,6,-7,8,-1,-7,-1,-1,-7,0,shortest
11,100,224,0.05,5,4,clustered,0.5;-0.15,3,3,3,0,0,3,0,3,3,0,0,shortest
9,100,256,0.05,3,2,clustered,0.5;-0.15,14,14,4,10,0,6,2,6,6,2,0,shortest
8,100,271,0.05,5,4,clustered,0.5;-0.15,14,14,4,10,0,-1,-5,-1,-1,-5,0,shortest
7,100,249,0.05,3,2,clustered,0.5;-0.15,-1,-1,5,-6,0,-1,-6,-1,-1,-6,0,shortest
6,100,252,0.05,4,3,clustered,0.5;-0.15,34,34,4,30,0,10,6,4,4,0,0,shortest
5,100,256,0.05,5,4,clustered,0.5;-0.15,15,15,5,10,4,-1,-6,-1,-1,-6,0,shortest
4,100,207,0.05,4,3,clustered,0.5;-0.15,30,30,6,24,0,20,14,20,20,14,0,shortest
3,100,253,0.05,5,4,clustered,0.5;-0.15,8,8,4,4,0,8,4,8,8,4,0,shortest
2,100,261,0.05,5,4,clustered,0.5;-0.15,6,18,4,2,0,6,2,6,6,2,0,shortest
1,100,236,0.05,2,1,clustered,0.5;-0.15,-1,-1,6,-7,0,-1,-7,-1,-1,-7,0,shortest
