rep,nrNodes,nrEdges,edgeProb,nrPaths,nrFails,failureModel,failurePercent,hopsRanked,hopsUnranked,spLength,stretch_mult,nodeAdditions,hopsPath,stretch_path,hopsRankedOne,hopsUnrankedOne,stretch_one,overallNodeAdditionsOne,treeChoice
998,25,56,graphml/AttMpls.graphml,2,1,clustered,0.6;-0.3,3,5,3,0,26,3,0,3,3,0,12,shortest
997,25,56,graphml/AttMpls.graphml,3,2,clustered,0.6;-0.3,25,21,5,20,4,-1,-6,-1,-1,-6,0,shortest
996,25,56,graphml/AttMpls.graphml,4,3,clustered,0.6;-0.3,2,2,2,0,0,2,0,2,2,0,0,shortest
995,25,56,graphml/AttMpls.graphml,4,3,clustered,0.6;-0.3,-1,-1,3,-4,16,-1,-4,-1,-1,-4,10,shortest
994,25,56,graphml/AttMpls.graphml,2,1,clustered,0.6;-0.3,8,6,4,4,0,6,2,6,6,2,0,shortest
993,25,56,graphml/AttMpls.graphml,3,2,clustered,0.6;-0.3,3,3,3,0,0,3,0,3,3,0,0,shortest
992,25,56,graphml/AttMpls.graphml,4,3,clustered,0.6;-0.3,11,11,5,6,0,15,10,15,15,10,0,shortest
991,25,56,graphml/AttMpls.graphml,3,2,clustered,0.6;-0.3,4,4,2,2,8,-1,-3,2,2,0,0,shortest
990,25,56,graphml/AttMpls.graphml,2,1,clustered,0.6;-0.3,3,7,3,0,0,3,0,3,3,0,0,shortest
989,25,56,graphml/AttMpls.graphml,3,2,clustered,0.6;-0.3,4,4,4,0,0,4,0,4,4,0,0,shortest
988,25,56,graphml/AttMpls.graphml,2,1,clustered,0.6;-0.3,4,4,4,0,0,4,0,4,4,0,0,shortest
987,25,56,graphml/AttMpls.graphml,3,2,clustered,0.6;-0.3,7,13,4,3,6,7,3,7,7,3,0,shortest
986,25,56,graphml/AttMpls.graphml,4,3,clustered,0.6;-0.3,8,8,3,5,0,8,5,8,8,5,0,shortest
985,25,56,graphml/AttMpls.graphml,4,3,clustered,0.6;-0.3,4,4,3,1,0,3,0,4,4,1,0,shortest
984,25,56,graphml/AttMpls.graphml,4,3,clustered,0.6;-0.3,14,12,5,9,0,12,7,12,12,7,0,shortest
983,25,56,graphml/AttMpls.graphml,2,1,clustered,0.6;-0.3,9,9,4,5,0,8,4,8,8,4,0,shortest
982,25,56,graphml/AttMpls.graphml,3,2,clustered,0.6;-0.3,7,11,5,2,12,-1,-6,-1,-1,-6,8,shortest
981,25,56,graphml/AttMpls.graphml,2,1,clustered,0.6;-0.3,2,2,2,0,0,2,0,2,2,0,0,shortest
980,25,56,graphml/AttMpls.graphml,9,8,clustered,0.6;-0.3,2,2,2,0,0,2,0,2,2,0,0,shortest
979,25,56,graphml/AttMpls.graphml,3,2,clustered,0.6;-0.3,2,2,2,0,14,2,0,2,2,0,14,shortest
978,25,56,graphml/AttMpls.graphml,2,1,clustered,0.6;-0.3,8,6,4,4,2,9,5,9,9,5,0,shortest
977,25,56,graphml/AttMpls.graphml,3,2,clustered,0.6;-0.3,6,4,4,2,6,4,0,4,4,0,0,shortest
976,25,56,graphml/AttMpls.graphml,2,1,clustered,0.6;-0.3,27,25,5,22,12,-1,-6,-1,-1,-6,0,shortest
974,25,56,graphml/AttMpls.graphml,4,3,clustered,0.6;-0.3,2,2,2,0,0,2,0,2,2,0,0,shortest
971,25,56,graphml/AttMpls.graphml,3,2,clustered,0.6;-0.3,18,14,5,13,2,-1,-6,-1,-1,-6,2,shortest
970,25,56,graphml/AttMpls.graphml,3,2,clustered,0.6;-0.3,3,5,3,0,0,3,0,3,3,0,0,shortest
969,25,56,graphml/AttMpls.graphml,2,1,clustered,0.6;-0.3,-1,-1,7,-8,4,-1,-8,-1,-1,-8,0,shortest
968,25,56,graphml/AttMpls.graphml,3,2,clustered,0.6;-0.3,-1,-1,4,-5,4,-1,-5,-1,-1,-5,0,shortest
967,25,56,graphml/AttMpls.graphml,3,2,clustered,0.6;-0.3,4,10,3,1,10,5,2,5,5,2,2,shortest
966,25,56,graphml/AttMpls.graphml,2,1,clustered,0.6;-0.3,-1,-1,3,-4,0,-1,-4,-1,-1,-4,0,shortest
965,25,56,graphml/AttMpls.graphml,3,2,clustered,0.6;-0.3,15,9,3,12,0,7,4,7,7,4,0,shortest
964,25,56,graphml/AttMpls.graphml,2,1,clustered,0.6;-0.3,11,11,4,7,0,4,0,10,10,6,0,shortest
963,25,56,graphml/AttMpls.graphml,4,3,clustered,0.6;-0.3,4,4,4,0,4,6,2,4,4,0,0,shortest
962,25,56,graphml/AttMpls.graphml,4,3,clustered,0.6;-0.3,17,25,4,13,0,-1,-5,-1,-1,-5,0,shortest
961,25,56,graphml/AttMpls.graphml,2,1,clustered,0.6;-0.3,8,8,6,2,0,-1,-7,-1,-1,-7,0,shortest
960,25,56,graphml/AttMpls.graphml,3,2,clustered,0.6;-0.3,6,12,4,2,24,10,6,7,15,3,12,shortest
959,25,56,graphml/AttMpls.graphml,4,3,clustered,0.6;-0.3,8,8,3,5,4,8,5,8,8,5,0,shortest
958,25,56,graphml/AttMpls.graphml,3,2,clustered,0.6;-0.3,4,4,4,0,0,4,0,4,4,0,0,shortest
957,25,56,graphml/AttMpls.graphml,2,1,clustered,0.6;-0.3,2,2,2,0,0,2,0,2,2,0,0,shortest
956,25,56,graphml/AttMpls.graphml,2,1,clustered,0.6;-0.3,16,16,4,12,0,-1,-5,-1,-1,-5,0,shortest
955,25,56,graphml/AttMpls.graphml,2,1,clustered,0.6;-0.3,5,5,3,2,0,5,2,5,5,2,0,shortest
954,25,56,graphml/AttMpls.graphml,5,4,clustered,0.6;-0.3,2,2,2,0,2,2,0,2,2,0,0,shortest
953,25,56,graphml/AttMpls.graphml,3,2,clustered,0.6;-0.3,15,13,5,10,20,-1,-6,-1,-1,-6,0,shortest
951,25,56,graphml/AttMpls.graphml,3,2,clustered,0.6;-0.3,4,4,3,1,0,-1,-4,-1,-1,-4,0,shortest
950,25,56,graphml/AttMpls.graphml,2,1,clustered,0.6;-0.3,4,4,4,0,0,4,0,4,4,0,0,shortest
949,25,56,graphml/AttMpls.graphml,4,3,clustered,0.6;-0.3,3,3,3,0,12,3,0,3,3,0,6,shortest
947,25,56,graphml/AttMpls.graphml,4,3,clustered,0.6;-0.3,11,17,4,7,2,11,7,11,11,7,0,shortest
946,25,56,graphml/AttMpls.graphml,2,1,clustered,0.6;-0.3,4,8,3,1,0,-1,-4,-1,-1,-4,0,shortest
945,25,56,graphml/AttMpls.graphml,2,1,clustered,0.6;-0.3,4,4,4,0,0,4,0,4,4,0,0,shortest
944,25,56,graphml/AttMpls.graphml,3,2,clustered,0.6;-0.3,3,3,3,0,8,3,0,3,3,0,4,shortest
943,25,56,graphml/AttMpls.graphml,2,1,clustered,0.6;-0.3,3,3,3,0,0,3,0,3,3,0,0,shortest
942,25,56,graphml/AttMpls.graphml,4,3,clustered,0.6;-0.3,4,4,4,0,0,12,8,4,4,0,0,shortest
941,25,56,graphml/AttMpls.graphml,2,1,clustered,0.6;-0.3,2,2,2,0,12,2,0,2,2,0,0,shortest
939,25,56,graphml/AttMpls.graphml,5,4,clustered,0.6;-0.3,2,2,2,0,2,4,2,4,4,2,0,shortest
938,25,56,graphml/AttMpls.graphml,2,1,clustered,0.6;-0.3,3,7,3,0,12,-1,-4,-1,-1,-4,0,shortest
937,25,56,graphml/AttMpls.graphml,3,2,clustered,0.6;-0.3,-1,-1,4,-5,0,-1,-5,-1,-1,-5,0,shortest
936,25,56,graphml/AttMpls.graphml,2,1,clustered,0.6;-0.3,17,17,5,12,22,-1,-6,-1,-1,-6,4,shortest
935,25,56,graphml/AttMpls.graphml,3,2,clustered,0.6;-0.3,16,18,5,11,20,-1,-6,-1,-1,-6,0,shortest
934,25,56,graphml/AttMpls.graphml,3,2,clustered,0.6;-0.3,2,2,2,0,0,2,0,2,2,0,0,shortest
933,25,56,graphml/AttMpls.graphml,3,2,clustered,0.6;-0.3,8,8,4,4,0,4,0,8,8,4,0,shortest
932,25,56,graphml/AttMpls.graphml,5,4,clustered,0.6;-0.3,5,9,3,2,2,5,2,5,5,2,0,shortest
931,25,56,graphml/AttMpls.graphml,2,1,clustered,0.6;-0.3,3,3,3,0,0,3,0,3,3,0,0,shortest
930,25,56,graphml/AttMpls.graphml,4,3,clustered,0.6;-0.3,10,10,4,6,0,8,4,8,8,4,0,shortest
929,25,56,graphml/AttMpls.graphml,3,2,clustered,0.6;-0.3,7,7,4,3,4,11,7,6,6,2,0,shortest
928,25,56,graphml/AttMpls.graphml,4,3,clustered,0.6;-0.3,2,2,2,0,0,2,0,2,2,0,0,shortest
927,25,56,graphml/AttMpls.graphml,2,1,clustered,0.6;-0.3,-1,-1,5,-6,2,-1,-6,-1,-1,-6,0,shortest
926,25,56,graphml/AttMpls.graphml,2,1,clustered,0.6;-0.3,15,15,5,10,12,-1,-6,-1,-1,-6,0,shortest
925,25,56,graphml/AttMpls.graphml,5,4,clustered,0.6;-0.3,5,5,3,2,2,22,19,7,7,4,0,shortest
924,25,56,graphml/AttMpls.graphml,5,4,clustered,0.6;-0.3,8,8,3,5,0,12,9,8,8,5,0,shortest
923,25,56,graphml/AttMpls.graphml,3,2,clustered,0.6;-0.3,18,12,4,14,2,-1,-5,-1,-1,-5,0,shortest
921,25,56,graphml/AttMpls.graphml,3,2,clustered,0.6;-0.3,4,4,4,0,0,4,0,4,4,0,0,shortest
920,25,56,graphml/AttMpls.graphml,3,2,clustered,0.6;-0.3,2,2,2,0,0,2,0,2,2,0,0,shortest
919,25,56,graphml/AttMpls.graphml,4,3,clustered,0.6;-0.3,8,8,2,6,0,-1,-3,2,2,0,0,shortest
918,25,56,graphml/AttMpls.graphml,2,1,clustered,0.6;-0.3,5,5,5,0,0,-1,-6,-1,-1,-6,0,shortest
917,25,56,graphml/AttMpls.graphml,2,1,clustered,0.6;-0.3,3,5,3,0,12,3,0,3,3,0,0,shortest
916,25,56,graphml/AttMpls.graphml,2,1,clustered,0.6;-0.3,-1,-1,4,-5,0,-1,-5,-1,-1,-5,0,shortest
915,25,56,graphml/AttMpls.graphml,4,3,clustered,0.6;-0.3,11,15,3,8,0,5,2,9,9,6,0,shortest
914,25,56,graphml/AttMpls.graphml,2,1,clustered,0.6;-0.3,4,4,4,0,0,-1,-5,-1,-1,-5,0,shortest
912,25,56,graphml/AttMpls.graphml,2,1,clustered,0.6;-0.3,5,5,4,1,8,-1,-5,-1,-1,-5,4,shortest
911,25,56,graphml/AttMpls.graphml,3,2,clustered,0.6;-0.3,4,4,3,1,16,10,7,10,10,7,0,shortest
910,25,56,graphml/AttMpls.graphml,2,1,clustered,0.6;-0.3,4,4,4,0,0,-1,-5,-1,-1,-5,0,shortest
909,25,56,graphml/AttMpls.graphml,2,1,clustered,0.6;-0.3,2,2,2,0,0,2,0,2,2,0,0,shortest
908,25,56,graphml/AttMpls.graphml,2,1,clustered,0.6;-0.3,6,6,3,3,0,6,3,6,6,3,0,shortest
907,25,56,graphml/AttMpls.graphml,3,2,clustered,0.6;-0.3,3,3,3,0,20,3,0,3,3,0,0,shortest
906,25,56,graphml/AttMpls.graphml,2,1,clustered,0.6;-0.3,5,3,3,2,12,3,0,3,3,0,0,shortest
905,25,56,graphml/AttMpls.graphml,2,1,clustered,0.6;-0.3,22,22,4,18,8,-1,-5,-1,-1,-5,0,shortest
904,25,56,graphml/AttMpls.graphml,2,1,clustered,0.6;-0.3,7,7,5,2,8,-1,-6,-1,-1,-6,0,shortest
903,25,56,graphml/AttMpls.graphml,3,2,clustered,0.6;-0.3,27,19,6,21,4,-1,-7,-1,-1,-7,0,shortest
902,25,56,graphml/AttMpls.graphml,3,2,clustered,0.6;-0.3,6,12,3,3,0,6,3,6,6,3,0,shortest
901,25,56,graphml/AttMpls.graphml,4,3,clustered,0.6;-0.3,10,11,3,7,16,11,8,11,11,8,0,shortest
900,25,56,graphml/AttMpls.graphml,3,2,clustered,0.6;-0.3,4,4,4,0,0,5,1,4,4,0,0,shortest
898,25,56,graphml/AttMpls.graphml,2,1,clustered,0.6;-0.3,-1,-1,4,-5,0,-1,-5,-1,-1,-5,0,shortest
897,25,56,graphml/AttMpls.graphml,2,1,clustered,0.6;-0.3,-1,-1,5,-6,0,-1,-6,-1,-1,-6,0,shortest
896,25,56,graphml/AttMpls.graphml,2,1,clustered,0.6;-0.3,-1,-1,6,-7,6,-1,-7,-1,-1,-7,2,shortest
895,25,56,graphml/AttMpls.graphml,3,2,clustered,0.6;-0.3,3,3,3,0,4,12,9,3,3,0,2,shortest
894,25,56,graphml/AttMpls.graphml,3,2,clustered,0.6;-0.3,10,10,5,5,4,-1,-6,-1,-1,-6,0,shortest
893,25,56,graphml/AttMpls.graphml,4,3,clustered,0.6;-0.3,4,12,4,0,0,14,10,4,4,0,0,shortest
892,25,56,graphml/AttMpls.graphml,4,3,clustered,0.6;-0.3,4,4,2,2,0,4,2,4,4,2,0,shortest
891,25,56,graphml/AttMpls.graphml,3,2,clustered,0.6;-0.3,10,8,4,6,8,-1,-5,-1,-1,-5,0,shortest
890,25,56,graphml/AttMpls.graphml,4,3,clustered,0.6;-0.3,23,23,4,19,0,17,13,17,17,13,0,shortest
888,25,56,graphml/AttMpls.graphml,2,1,clustered,0.6;-0.3,3,5,3,0,0,3,0,3,3,0,0,shortest
887,25,56,graphml/AttMpls.graphml,2,1,clustered,0.6;-0.3,3,3,3,0,0,3,0,3,3,0,0,shortest
886,25,56,graphml/AttMpls.graphml,2,1,clustered,0.6;-0.3,3,3,3,0,0,3,0,3,3,0,0,shortest
885,25,56,graphml/AttMpls.graphml,3,2,clustered,0.6;-0.3,7,7,3,4,0,5,2,7,7,4,0,shortest
884,25,56,graphml/AttMpls.graphml,4,3,clustered,0.6;-0.3,20,16,3,17,18,12,9,12,12,9,0,shortest
883,25,56,graphml/AttMpls.graphml,3,2,clustered,0.6;-0.3,5,5,3,2,0,3,0,5,5,2,0,shortest
882,25,56,graphml/AttMpls.graphml,4,3,clustered,0.6;-0.3,2,2,2,0,0,2,0,2,2,0,0,shortest
881,25,56,graphml/AttMpls.graphml,6,5,clustered,0.6;-0.3,10,10,2,8,10,22,20,8,8,6,0,shortest
880,25,56,graphml/AttMpls.graphml,4,3,clustered,0.6;-0.3,3,3,3,0,4,3,0,3,3,0,2,shortest
878,25,56,graphml/AttMpls.graphml,2,1,clustered,0.6;-0.3,3,3,3,0,0,6,3,6,6,3,0,shortest
877,25,56,graphml/AttMpls.graphml,5,4,clustered,0.6;-0.3,9,9,3,6,4,11,8,23,23,20,2,shortest
876,25,56,graphml/AttMpls.graphml,5,4,clustered,0.6;-0.3,10,6,3,7,2,-1,-4,-1,-1,-4,0,shortest
875,25,56,graphml/AttMpls.graphml,3,2,clustered,0.6;-0.3,14,14,5,9,0,10,5,10,10,5,0,shortest
874,25,56,graphml/AttMpls.graphml,4,3,clustered,0.6;-0.3,6,6,3,3,0,6,3,6,6,3,0,shortest
873,25,56,graphml/AttMpls.graphml,3,2,clustered,0.6;-0.3,-1,-1,6,-7,0,-1,-7,-1,-1,-7,0,shortest
871,25,56,graphml/AttMpls.graphml,3,2,clustered,0.6;-0.3,10,8,4,6,20,-1,-5,7,5,3,12,shortest
870,25,56,graphml/AttMpls.graphml,2,1,clustered,0.6;-0.3,21,21,5,16,0,-1,-6,-1,-1,-6,0,shortest
869,25,56,graphml/AttMpls.graphml,3,2,clustered,0.6;-0.3,3,3,3,0,0,3,0,3,3,0,0,shortest
868,25,56,graphml/AttMpls.graphml,2,1,clustered,0.6;-0.3,3,3,3,0,6,-1,-4,5,5,2,2,shortest
867,25,56,graphml/AttMpls.graphml,3,2,clustered,0.6;-0.3,-1,-1,6,-7,4,-1,-7,-1,-1,-7,0,shortest
866,25,56,graphml/AttMpls.graphml,3,2,clustered,0.6;-0.3,20,20,4,16,0,8,4,8,8,4,0,shortest
865,25,56,graphml/AttMpls.graphml,4,3,clustered,0.6;-0.3,5,5,2,3,0,4,2,4,4,2,0,shortest
863,25,56,graphml/AttMpls.graphml,4,3,clustered,0.6;-0.3,4,4,4,0,0,4,0,10,10,6,0,shortest
862,25,56,graphml/AttMpls.graphml,4,3,clustered,0.6;-0.3,4,4,3,1,0,-1,-4,7,7,4,0,shortest
861,25,56,graphml/AttMpls.graphml,2,1,clustered,0.6;-0.3,3,3,3,0,6,3,0,3,3,0,0,shortest
860,25,56,graphml/AttMpls.graphml,2,1,clustered,0.6;-0.3,10,12,4,6,0,-1,-5,-1,-1,-5,0,shortest
859,25,56,graphml/AttMpls.graphml,4,3,clustered,0.6;-0.3,2,2,2,0,12,5,3,2,2,0,0,shortest
857,25,56,graphml/AttMpls.graphml,3,2,clustered,0.6;-0.3,23,17,4,19,0,-1,-5,13,13,9,0,shortest
856,25,56,graphml/AttMpls.graphml,4,3,clustered,0.6;-0.3,2,2,2,0,0,4,2,4,4,2,0,shortest
855,25,56,graphml/AttMpls.graphml,2,1,clustered,0.6;-0.3,2,2,2,0,2,2,0,2,2,0,0,shortest
853,25,56,graphml/AttMpls.graphml,2,1,clustered,0.6;-0.3,8,8,4,4,0,-1,-5,-1,-1,-5,0,shortest
852,25,56,graphml/AttMpls.graphml,4,3,clustered,0.6;-0.3,3,3,3,0,6,5,2,5,5,2,0,shortest
851,25,56,graphml/AttMpls.graphml,2,1,clustered,0.6;-0.3,10,16,4,6,14,-1,-5,-1,-1,-5,0,shortest
850,25,56,graphml/AttMpls.graphml,4,3,clustered,0.6;-0.3,3,3,3,0,0,-1,-4,3,3,0,0,shortest
848,25,56,graphml/AttMpls.graphml,2,1,clustered,0.6;-0.3,5,5,4,1,10,4,0,10,10,6,0,shortest
847,25,56,graphml/AttMpls.graphml,2,1,clustered,0.6;-0.3,5,5,2,3,0,2,0,2,2,0,0,shortest
846,25,56,graphml/AttMpls.graphml,3,2,clustered,0.6;-0.3,2,2,2,0,0,2,0,2,2,0,0,shortest
845,25,56,graphml/AttMpls.graphml,4,3,clustered,0.6;-0.3,3,3,3,0,0,3,0,3,3,0,0,shortest
844,25,56,graphml/AttMpls.graphml,4,3,clustered,0.6;-0.3,18,26,4,14,18,-1,-5,-1,-1,-5,0,shortest
843,25,56,graphml/AttMpls.graphml,3,2,clustered,0.6;-0.3,13,15,4,9,10,-1,-5,13,13,9,4,shortest
842,25,56,graphml/AttMpls.graphml,4,3,clustered,0.6;-0.3,3,3,3,0,0,5,2,3,3,0,0,shortest
841,25,56,graphml/AttMpls.graphml,2,1,clustered,0.6;-0.3,3,3,3,0,0,3,0,3,3,0,0,shortest
840,25,56,graphml/AttMpls.graphml,2,1,clustered,0.6;-0.3,3,3,2,1,0,2,0,2,2,0,0,shortest
839,25,56,graphml/AttMpls.graphml,2,1,clustered,0.6;-0.3,-1,-1,3,-4,14,-1,-4,-1,-1,-4,0,shortest
838,25,56,graphml/AttMpls.graphml,4,3,clustered,0.6;-0.3,-1,-1,4,-5,6,-1,-5,-1,-1,-5,0,shortest
837,25,56,graphml/AttMpls.graphml,4,3,clustered,0.6;-0.3,7,7,3,4,18,7,4,7,7,4,0,shortest
836,25,56,graphml/AttMpls.graphml,2,1,clustered,0.6;-0.3,14,14,4,10,0,-1,-5,4,4,0,0,shortest
835,25,56,graphml/AttMpls.graphml,3,2,clustered,0.6;-0.3,3,3,3,0,0,3,0,3,3,0,0,shortest
834,25,56,graphml/AttMpls.graphml,2,1,clustered,0.6;-0.3,16,16,5,11,8,-1,-6,-1,-1,-6,0,shortest
833,25,56,graphml/AttMpls.graphml,2,1,clustered,0.6;-0.3,11,11,3,8,8,-1,-4,3,3,0,0,shortest
832,25,56,graphml/AttMpls.graphml,3,2,clustered,0.6;-0.3,2,2,2,0,0,5,3,3,3,1,0,shortest
831,25,56,graphml/AttMpls.graphml,2,1,clustered,0.6;-0.3,3,3,3,0,12,3,0,3,3,0,0,shortest
830,25,56,graphml/AttMpls.graphml,5,4,clustered,0.6;-0.3,24,14,4,20,0,4,0,12,12,8,0,shortest
829,25,56,graphml/AttMpls.graphml,2,1,clustered,0.6;-0.3,10,16,4,6,8,-1,-5,-1,-1,-5,0,shortest
828,25,56,graphml/AttMpls.graphml,2,1,clustered,0.6;-0.3,17,29,4,13,2,9,5,9,9,5,0,shortest
826,25,56,graphml/AttMpls.graphml,2,1,clustered,0.6;-0.3,17,11,5,12,0,-1,-6,-1,-1,-6,0,shortest
825,25,56,graphml/AttMpls.graphml,3,2,clustered,0.6;-0.3,5,7,3,2,8,-1,-4,11,11,8,6,shortest
824,25,56,graphml/AttMpls.graphml,2,1,clustered,0.6;-0.3,4,8,4,0,8,-1,-5,-1,-1,-5,0,shortest
823,25,56,graphml/AttMpls.graphml,2,1,clustered,0.6;-0.3,7,5,4,3,12,8,4,8,8,4,0,shortest
822,25,56,graphml/AttMpls.graphml,4,3,clustered,0.6;-0.3,14,14,4,10,0,14,10,14,14,10,0,shortest
821,25,56,graphml/AttMpls.graphml,2,1,clustered,0.6;-0.3,3,7,3,0,12,3,0,3,3,0,0,shortest
820,25,56,graphml/AttMpls.graphml,3,2,clustered,0.6;-0.3,3,3,3,0,0,3,0,3,3,0,0,shortest
819,25,56,graphml/AttMpls.graphml,2,1,clustered,0.6;-0.3,7,5,4,3,0,8,4,8,8,4,0,shortest
818,25,56,graphml/AttMpls.graphml,2,1,clustered,0.6;-0.3,5,5,5,0,2,5,0,5,5,0,0,shortest
817,25,56,graphml/AttMpls.graphml,3,2,clustered,0.6;-0.3,3,3,3,0,8,7,4,7,7,4,2,shortest
816,25,56,graphml/AttMpls.graphml,3,2,clustered,0.6;-0.3,4,4,4,0,0,10,6,10,10,6,0,shortest
814,25,56,graphml/AttMpls.graphml,2,1,clustered,0.6;-0.3,5,9,3,2,8,-1,-4,-1,-1,-4,0,shortest
813,25,56,graphml/AttMpls.graphml,3,2,clustered,0.6;-0.3,8,8,3,5,6,-1,-4,8,8,5,4,shortest
812,25,56,graphml/AttMpls.graphml,3,2,clustered,0.6;-0.3,14,14,4,10,0,4,0,12,12,8,0,shortest
811,25,56,graphml/AttMpls.graphml,2,1,clustered,0.6;-0.3,12,10,5,7,6,-1,-6,-1,-1,-6,0,shortest
810,25,56,graphml/AttMpls.graphml,2,1,clustered,0.6;-0.3,-1,-1,4,-5,8,-1,-5,-1,-1,-5,4,shortest
809,25,56,graphml/AttMpls.graphml,3,2,clustered,0.6;-0.3,3,3,3,0,0,5,2,5,5,2,0,shortest
807,25,56,graphml/AttMpls.graphml,3,2,clustered,0.6;-0.3,2,2,2,0,8,4,2,4,4,2,4,shortest
806,25,56,graphml/AttMpls.graphml,2,1,clustered,0.6;-0.3,17,17,4,13,8,-1,-5,-1,-1,-5,0,shortest
804,25,56,graphml/AttMpls.graphml,2,1,clustered,0.6;-0.3,7,7,5,2,0,-1,-6,-1,-1,-6,0,shortest
802,25,56,graphml/AttMpls.graphml,4,3,clustered,0.6;-0.3,6,6,4,2,4,-1,-5,-1,-1,-5,0,shortest
801,25,56,graphml/AttMpls.graphml,4,3,clustered,0.6;-0.3,5,5,3,2,0,-1,-4,3,3,0,0,shortest
800,25,56,graphml/AttMpls.graphml,2,1,clustered,0.6;-0.3,5,5,4,1,22,8,4,8,8,4,0,shortest
799,25,56,graphml/AttMpls.graphml,4,3,clustered,0.6;-0.3,4,4,4,0,0,4,0,4,4,0,0,shortest
798,25,56,graphml/AttMpls.graphml,3,2,clustered,0.6;-0.3,8,10,3,5,0,4,1,4,4,1,0,shortest
797,25,56,graphml/AttMpls.graphml,3,2,clustered,0.6;-0.3,23,37,4,19,2,-1,-5,15,15,11,0,shortest
796,25,56,graphml/AttMpls.graphml,6,5,clustered,0.6;-0.3,3,11,2,1,0,7,5,7,7,5,0,shortest
795,25,56,graphml/AttMpls.graphml,4,3,clustered,0.6;-0.3,5,5,3,2,0,5,2,5,5,2,0,shortest
794,25,56,graphml/AttMpls.graphml,3,2,clustered,0.6;-0.3,14,14,3,11,8,-1,-4,10,10,7,4,shortest
793,25,56,graphml/AttMpls.graphml,2,1,clustered,0.6;-0.3,9,9,4,5,2,-1,-5,-1,-1,-5,0,shortest
792,25,56,graphml/AttMpls.graphml,2,1,clustered,0.6;-0.3,7,4,4,3,18,6,2,6,6,2,0,shortest
791,25,56,graphml/AttMpls.graphml,3,2,clustered,0.6;-0.3,10,10,4,6,6,8,4,8,8,4,0,shortest
790,25,56,graphml/AttMpls.graphml,3,2,clustered,0.6;-0.3,5,5,3,2,20,5,2,3,3,0,0,shortest
789,25,56,graphml/AttMpls.graphml,5,4,clustered,0.6;-0.3,20,20,3,17,0,10,7,20,20,17,0,shortest
788,25,56,graphml/AttMpls.graphml,4,3,clustered,0.6;-0.3,8,12,4,4,12,-1,-5,-1,-1,-5,0,shortest
786,25,56,graphml/AttMpls.graphml,3,2,clustered,0.6;-0.3,4,4,2,2,0,2,0,2,2,0,0,shortest
784,25,56,graphml/AttMpls.graphml,2,1,clustered,0.6;-0.3,7,7,3,4,0,-1,-4,-1,-1,-4,0,shortest
783,25,56,graphml/AttMpls.graphml,2,1,clustered,0.6;-0.3,3,3,2,1,8,2,0,2,2,0,0,shortest
782,25,56,graphml/AttMpls.graphml,3,2,clustered,0.6;-0.3,10,10,2,8,0,-1,-3,4,4,2,0,shortest
781,25,56,graphml/AttMpls.graphml,4,3,clustered,0.6;-0.3,11,11,3,8,0,5,2,11,11,8,0,shortest
780,25,56,graphml/AttMpls.graphml,3,2,clustered,0.6;-0.3,4,4,4,0,4,-1,-5,4,4,0,0,shortest
779,25,56,graphml/AttMpls.graphml,2,1,clustered,0.6;-0.3,11,11,4,7,0,10,6,10,10,6,0,shortest
778,25,56,graphml/AttMpls.graphml,2,1,clustered,0.6;-0.3,6,6,6,0,6,-1,-7,16,16,10,2,shortest
776,25,56,graphml/AttMpls.graphml,2,1,clustered,0.6;-0.3,4,10,3,1,0,4,1,4,4,1,0,shortest
773,25,56,graphml/AttMpls.graphml,4,3,clustered,0.6;-0.3,-1,-1,5,-6,4,-1,-6,-1,-1,-6,0,shortest
770,25,56,graphml/AttMpls.graphml,4,3,clustered,0.6;-0.3,3,3,3,0,6,3,0,3,3,0,0,shortest
769,25,56,graphml/AttMpls.graphml,3,2,clustered,0.6;-0.3,9,9,5,4,0,5,0,13,13,8,0,shortest
768,25,56,graphml/AttMpls.graphml,3,2,clustered,0.6;-0.3,3,3,3,0,10,3,0,3,3,0,4,shortest
767,25,56,graphml/AttMpls.graphml,5,4,clustered,0.6;-0.3,4,4,2,2,2,4,2,4,4,2,0,shortest
766,25,56,graphml/AttMpls.graphml,2,1,clustered,0.6;-0.3,2,2,2,0,12,2,0,2,2,0,0,shortest
765,25,56,graphml/AttMpls.graphml,4,3,clustered,0.6;-0.3,3,3,3,0,0,3,0,3,3,0,0,shortest
764,25,56,graphml/AttMpls.graphml,3,2,clustered,0.6;-0.3,19,13,4,15,20,13,9,13,13,9,0,shortest
763,25,56,graphml/AttMpls.graphml,3,2,clustered,0.6;-0.3,6,8,4,2,4,-1,-5,-1,-1,-5,0,shortest
762,25,56,graphml/AttMpls.graphml,2,1,clustered,0.6;-0.3,4,4,4,0,0,8,4,4,4,0,0,shortest
761,25,56,graphml/AttMpls.graphml,4,3,clustered,0.6;-0.3,2,2,2,0,12,3,1,2,2,0,0,shortest
760,25,56,graphml/AttMpls.graphml,2,1,clustered,0.6;-0.3,8,8,4,4,0,8,4,8,8,4,0,shortest
759,25,56,graphml/AttMpls.graphml,6,5,clustered,0.6;-0.3,13,13,3,10,0,-1,-4,9,9,6,0,shortest
757,25,56,graphml/AttMpls.graphml,3,2,clustered,0.6;-0.3,4,4,4,0,0,12,8,4,4,0,0,shortest
756,25,56,graphml/AttMpls.graphml,2,1,clustered,0.6;-0.3,10,8,4,6,0,8,4,8,8,4,0,shortest
755,25,56,graphml/AttMpls.graphml,3,2,clustered,0.6;-0.3,2,2,2,0,8,2,0,2,2,0,6,shortest
754,25,56,graphml/AttMpls.graphml,5,4,clustered,0.6;-0.3,2,2,2,0,2,2,0,2,2,0,0,shortest
753,25,56,graphml/AttMpls.graphml,4,3,clustered,0.6;-0.3,4,4,3,1,0,14,11,14,14,11,0,shortest
752,25,56,graphml/AttMpls.graphml,2,1,clustered,0.6;-0.3,3,5,2,1,0,2,0,2,2,0,0,shortest
750,25,56,graphml/AttMpls.graphml,7,6,clustered,0.6;-0.3,36,36,2,34,4,2,0,2,2,0,0,shortest
749,25,56,graphml/AttMpls.graphml,2,1,clustered,0.6;-0.3,2,2,2,0,14,2,0,2,2,0,0,shortest
748,25,56,graphml/AttMpls.graphml,4,3,clustered,0.6;-0.3,2,2,2,0,0,2,0,2,2,0,0,shortest
747,25,56,graphml/AttMpls.graphml,4,3,clustered,0.6;-0.3,3,11,3,0,0,3,0,3,3,0,0,shortest
746,25,56,graphml/AttMpls.graphml,2,1,clustered,0.6;-0.3,7,7,4,3,0,4,0,10,10,6,0,shortest
744,25,56,graphml/AttMpls.graphml,3,2,clustered,0.6;-0.3,-1,-1,5,-6,0,-1,-6,-1,-1,-6,0,shortest
743,25,56,graphml/AttMpls.graphml,3,2,clustered,0.6;-0.3,2,2,2,0,0,4,2,4,4,2,0,shortest
742,25,56,graphml/AttMpls.graphml,4,3,clustered,0.6;-0.3,3,3,3,0,0,3,0,5,5,2,0,shortest
741,25,56,graphml/AttMpls.graphml,2,1,clustered,0.6;-0.3,2,2,2,0,2,2,0,2,2,0,0,shortest
738,25,56,graphml/AttMpls.graphml,2,1,clustered,0.6;-0.3,10,10,4,6,0,10,6,10,10,6,0,shortest
736,25,56,graphml/AttMpls.graphml,3,2,clustered,0.6;-0.3,25,27,4,21,0,19,15,19,19,15,0,shortest
735,25,56,graphml/AttMpls.graphml,4,3,clustered,0.6;-0.3,21,21,3,18,6,-1,-4,-1,-1,-4,2,shortest
734,25,56,graphml/AttMpls.graphml,4,3,clustered,0.6;-0.3,22,26,4,18,0,17,13,16,16,12,0,shortest
732,25,56,graphml/AttMpls.graphml,2,1,clustered,0.6;-0.3,5,5,3,2,0,7,4,7,7,4,0,shortest
731,25,56,graphml/AttMpls.graphml,3,2,clustered,0.6;-0.3,16,14,4,12,0,8,4,14,14,10,0,shortest
730,25,56,graphml/AttMpls.graphml,4,3,clustered,0.6;-0.3,3,3,3,0,4,3,0,3,3,0,0,shortest
729,25,56,graphml/AttMpls.graphml,4,3,clustered,0.6;-0.3,21,17,5,16,0,17,12,17,17,12,0,shortest
728,25,56,graphml/AttMpls.graphml,3,2,clustered,0.6;-0.3,9,9,4,5,0,8,4,9,9,5,0,shortest
726,25,56,graphml/AttMpls.graphml,2,1,clustered,0.6;-0.3,-1,-1,4,-5,0,-1,-5,-1,-1,-5,0,shortest
725,25,56,graphml/AttMpls.graphml,4,3,clustered,0.6;-0.3,13,13,3,10,6,5,2,9,9,6,0,shortest
723,25,56,graphml/AttMpls.graphml,2,1,clustered,0.6;-0.3,2,2,2,0,0,2,0,2,2,0,0,shortest
722,25,56,graphml/AttMpls.graphml,3,2,clustered,0.6;-0.3,4,4,2,2,0,-1,-3,4,4,2,0,shortest
721,25,56,graphml/AttMpls.graphml,3,2,clustered,0.6;-0.3,12,12,5,7,4,-1,-6,-1,-1,-6,0,shortest
719,25,56,graphml/AttMpls.graphml,3,2,clustered,0.6;-0.3,10,6,4,6,8,-1,-5,-1,-1,-5,0,shortest
718,25,56,graphml/AttMpls.graphml,3,2,clustered,0.6;-0.3,15,15,3,12,0,-1,-4,-1,-1,-4,0,shortest
717,25,56,graphml/AttMpls.graphml,2,1,clustered,0.6;-0.3,7,7,6,1,2,14,8,14,14,8,0,shortest
716,25,56,graphml/AttMpls.graphml,2,1,clustered,0.6;-0.3,3,3,3,0,10,5,2,5,5,2,0,shortest
715,25,56,graphml/AttMpls.graphml,3,2,clustered,0.6;-0.3,5,5,3,2,6,-1,-4,-1,-1,-4,4,shortest
714,25,56,graphml/AttMpls.graphml,4,3,clustered,0.6;-0.3,8,4,3,5,6,7,4,9,9,6,0,shortest
713,25,56,graphml/AttMpls.graphml,3,2,clustered,0.6;-0.3,3,3,3,0,24,10,7,7,15,4,12,shortest
712,25,56,graphml/AttMpls.graphml,2,1,clustered,0.6;-0.3,9,9,5,4,0,5,0,5,5,0,0,shortest
711,25,56,graphml/AttMpls.graphml,3,2,clustered,0.6;-0.3,11,11,4,7,0,8,4,8,8,4,0,shortest
710,25,56,graphml/AttMpls.graphml,4,3,clustered,0.6;-0.3,13,13,5,8,0,-1,-6,-1,-1,-6,0,shortest
709,25,56,graphml/AttMpls.graphml,3,2,clustered,0.6;-0.3,4,4,4,0,0,13,9,17,17,13,0,shortest
708,25,56,graphml/AttMpls.graphml,2,1,clustered,0.6;-0.3,9,9,5,4,0,12,7,12,12,7,0,shortest
707,25,56,graphml/AttMpls.graphml,5,4,clustered,0.6;-0.3,2,2,2,0,0,3,1,2,2,0,0,shortest
706,25,56,graphml/AttMpls.graphml,2,1,clustered,0.6;-0.3,-1,-1,4,-5,0,-1,-5,-1,-1,-5,0,shortest
705,25,56,graphml/AttMpls.graphml,5,4,clustered,0.6;-0.3,14,14,3,11,0,16,13,16,16,13,0,shortest
704,25,56,graphml/AttMpls.graphml,3,2,clustered,0.6;-0.3,4,4,4,0,0,5,1,4,4,0,0,shortest
703,25,56,graphml/AttMpls.graphml,3,2,clustered,0.6;-0.3,11,11,5,6,0,5,0,5,5,0,0,shortest
702,25,56,graphml/AttMpls.graphml,3,2,clustered,0.6;-0.3,3,5,3,0,22,-1,-4,-1,-1,-4,0,shortest
701,25,56,graphml/AttMpls.graphml,4,3,clustered,0.6;-0.3,9,9,4,5,6,-1,-5,9,9,5,4,shortest
699,25,56,graphml/AttMpls.graphml,4,3,clustered,0.6;-0.3,4,4,4,0,0,13,9,4,4,0,0,shortest
698,25,56,graphml/AttMpls.graphml,5,4,clustered,0.6;-0.3,-1,-1,6,-7,4,-1,-7,-1,-1,-7,2,shortest
697,25,56,graphml/AttMpls.graphml,3,2,clustered,0.6;-0.3,8,10,3,5,10,-1,-4,-1,-1,-4,0,shortest
696,25,56,graphml/AttMpls.graphml,2,1,clustered,0.6;-0.3,19,17,5,14,10,-1,-6,-1,-1,-6,4,shortest
695,25,56,graphml/AttMpls.graphml,4,3,clustered,0.6;-0.3,3,3,3,0,0,3,0,3,3,0,0,shortest
694,25,56,graphml/AttMpls.graphml,5,4,clustered,0.6;-0.3,4,4,2,2,0,4,2,4,4,2,0,shortest
693,25,56,graphml/AttMpls.graphml,5,4,clustered,0.6;-0.3,2,2,2,0,2,2,0,2,2,0,0,shortest
692,25,56,graphml/AttMpls.graphml,2,1,clustered,0.6;-0.3,-1,-1,4,-5,0,-1,-5,-1,-1,-5,0,shortest
691,25,56,graphml/AttMpls.graphml,3,2,clustered,0.6;-0.3,2,2,2,0,0,-1,-3,4,4,2,0,shortest
690,25,56,graphml/AttMpls.graphml,2,1,clustered,0.6;-0.3,3,3,3,0,12,3,0,3,3,0,0,shortest
688,25,56,graphml/AttMpls.graphml,2,1,clustered,0.6;-0.3,3,5,3,0,0,3,0,3,3,0,0,shortest
687,25,56,graphml/AttMpls.graphml,4,3,clustered,0.6;-0.3,11,17,3,8,0,7,4,9,9,6,0,shortest
686,25,56,graphml/AttMpls.graphml,3,2,clustered,0.6;-0.3,-1,-1,5,-6,2,-1,-6,-1,-1,-6,0,shortest
685,25,56,graphml/AttMpls.graphml,2,1,clustered,0.6;-0.3,5,15,5,0,0,5,0,5,5,0,0,shortest
684,25,56,graphml/AttMpls.graphml,9,8,clustered,0.6;-0.3,28,34,3,25,0,23,20,23,23,20,0,shortest
683,25,56,graphml/AttMpls.graphml,2,1,clustered,0.6;-0.3,7,5,4,3,12,8,4,8,8,4,0,shortest
682,25,56,graphml/AttMpls.graphml,3,2,clustered,0.6;-0.3,3,11,3,0,10,3,0,3,3,0,2,shortest
681,25,56,graphml/AttMpls.graphml,2,1,clustered,0.6;-0.3,4,4,4,0,0,10,6,4,4,0,0,shortest
680,25,56,graphml/AttMpls.graphml,4,3,clustered,0.6;-0.3,17,27,4,13,2,15,11,15,15,11,0,shortest
679,25,56,graphml/AttMpls.graphml,3,2,clustered,0.6;-0.3,2,2,2,0,0,2,0,2,2,0,0,shortest
676,25,56,graphml/AttMpls.graphml,2,1,clustered,0.6;-0.3,-1,-1,6,-7,14,-1,-7,-1,-1,-7,0,shortest
675,25,56,graphml/AttMpls.graphml,3,2,clustered,0.6;-0.3,12,10,3,9,0,12,9,8,8,5,0,shortest
674,25,56,graphml/AttMpls.graphml,3,2,clustered,0.6;-0.3,5,5,3,2,0,6,3,3,3,0,0,shortest
672,25,56,graphml/AttMpls.graphml,2,1,clustered,0.6;-0.3,3,3,3,0,0,3,0,5,5,2,0,shortest
671,25,56,graphml/AttMpls.graphml,3,2,clustered,0.6;-0.3,6,6,4,2,16,-1,-5,-1,-1,-5,8,shortest
670,25,56,graphml/AttMpls.graphml,2,1,clustered,0.6;-0.3,2,2,2,0,14,2,0,2,2,0,0,shortest
669,25,56,graphml/AttMpls.graphml,4,3,clustered,0.6;-0.3,4,4,2,2,0,7,5,4,4,2,0,shortest
668,25,56,graphml/AttMpls.graphml,3,2,clustered,0.6;-0.3,25,21,6,19,4,-1,-7,-1,-1,-7,0,shortest
666,25,56,graphml/AttMpls.graphml,4,3,clustered,0.6;-0.3,3,3,3,0,0,-1,-4,3,3,0,0,shortest
665,25,56,graphml/AttMpls.graphml,2,1,clustered,0.6;-0.3,6,10,4,2,12,-1,-5,-1,-1,-5,0,shortest
663,25,56,graphml/AttMpls.graphml,2,1,clustered,0.6;-0.3,4,4,4,0,0,-1,-5,-1,-1,-5,0,shortest
662,25,56,graphml/AttMpls.graphml,4,3,clustered,0.6;-0.3,2,2,2,0,2,2,0,2,2,0,0,shortest
661,25,56,graphml/AttMpls.graphml,3,2,clustered,0.6;-0.3,2,2,2,0,14,2,0,2,2,0,14,shortest
660,25,56,graphml/AttMpls.graphml,3,2,clustered,0.6;-0.3,2,2,2,0,4,2,0,2,2,0,2,shortest
659,25,56,graphml/AttMpls.graphml,3,2,clustered,0.6;-0.3,12,10,4,8,0,6,2,10,10,6,0,shortest
657,25,56,graphml/AttMpls.graphml,3,2,clustered,0.6;-0.3,3,3,3,0,0,3,0,5,5,2,0,shortest
655,25,56,graphml/AttMpls.graphml,3,2,clustered,0.6;-0.3,27,21,4,23,6,17,13,17,17,13,0,shortest
654,25,56,graphml/AttMpls.graphml,5,4,clustered,0.6;-0.3,9,9,4,5,2,21,17,21,21,17,0,shortest
653,25,56,graphml/AttMpls.graphml,5,4,clustered,0.6;-0.3,5,5,3,2,0,5,2,5,5,2,0,shortest
652,25,56,graphml/AttMpls.graphml,3,2,clustered,0.6;-0.3,10,6,4,6,10,-1,-5,-1,-1,-5,2,shortest
651,25,56,graphml/AttMpls.graphml,3,2,clustered,0.6;-0.3,5,5,3,2,0,5,2,5,5,2,0,shortest
650,25,56,graphml/AttMpls.graphml,2,1,clustered,0.6;-0.3,-1,-1,5,-6,4,-1,-6,-1,-1,-6,0,shortest
649,25,56,graphml/AttMpls.graphml,3,2,clustered,0.6;-0.3,-1,-1,6,-7,4,-1,-7,-1,-1,-7,0,shortest
648,25,56,graphml/AttMpls.graphml,3,2,clustered,0.6;-0.3,3,3,2,1,0,3,1,3,3,1,0,shortest
647,25,56,graphml/AttMpls.graphml,3,2,clustered,0.6;-0.3,16,14,5,11,0,14,9,14,14,9,0,shortest
646,25,56,graphml/AttMpls.graphml,2,1,clustered,0.6;-0.3,4,4,4,0,10,4,0,4,4,0,0,shortest
645,25,56,graphml/AttMpls.graphml,2,1,clustered,0.6;-0.3,6,6,4,2,12,6,2,6,6,2,0,shortest
644,25,56,graphml/AttMpls.graphml,4,3,clustered,0.6;-0.3,3,3,3,0,0,3,0,3,3,0,0,shortest
643,25,56,graphml/AttMpls.graphml,5,4,clustered,0.6;-0.3,2,2,2,0,2,3,1,2,2,0,0,shortest
642,25,56,graphml/AttMpls.graphml,3,2,clustered,0.6;-0.3,13,13,3,10,24,-1,-4,8,12,5,12,shortest
641,25,56,graphml/AttMpls.graphml,3,2,clustered,0.6;-0.3,2,2,2,0,0,2,0,2,2,0,0,shortest
640,25,56,graphml/AttMpls.graphml,2,1,clustered,0.6;-0.3,-1,-1,5,-6,0,-1,-6,-1,-1,-6,0,shortest
638,25,56,graphml/AttMpls.graphml,2,1,clustered,0.6;-0.3,4,4,2,2,0,2,0,2,2,0,0,shortest
637,25,56,graphml/AttMpls.graphml,2,1,clustered,0.6;-0.3,4,4,4,0,0,4,0,4,4,0,0,shortest
636,25,56,graphml/AttMpls.graphml,2,1,clustered,0.6;-0.3,-1,-1,4,-5,0,-1,-5,-1,-1,-5,0,shortest
635,25,56,graphml/AttMpls.graphml,3,2,clustered,0.6;-0.3,-1,-1,6,-7,4,-1,-7,-1,-1,-7,0,shortest
634,25,56,graphml/AttMpls.graphml,3,2,clustered,0.6;-0.3,3,3,3,0,4,4,1,3,3,0,0,shortest
633,25,56,graphml/AttMpls.graphml,2,1,clustered,0.6;-0.3,9,5,5,4,0,11,6,11,11,6,0,shortest
631,25,56,graphml/AttMpls.graphml,3,2,clustered,0.6;-0.3,2,2,2,0,14,4,2,4,4,2,0,shortest
630,25,56,graphml/AttMpls.graphml,3,2,clustered,0.6;-0.3,10,14,4,6,0,-1,-5,-1,-1,-5,0,shortest
628,25,56,graphml/AttMpls.graphml,4,3,clustered,0.6;-0.3,8,10,3,5,16,-1,-4,-1,-1,-4,0,shortest
626,25,56,graphml/AttMpls.graphml,3,2,clustered,0.6;-0.3,9,9,5,4,8,9,4,9,9,4,0,shortest
624,25,56,graphml/AttMpls.graphml,2,1,clustered,0.6;-0.3,5,5,3,2,0,-1,-4,-1,-1,-4,0,shortest
623,25,56,graphml/AttMpls.graphml,3,2,clustered,0.6;-0.3,7,7,3,4,0,12,9,7,7,4,0,shortest
622,25,56,graphml/AttMpls.graphml,4,3,clustered,0.6;-0.3,42,42,4,38,0,22,18,30,30,26,0,shortest
621,25,56,graphml/AttMpls.graphml,3,2,clustered,0.6;-0.3,2,2,2,0,0,5,3,3,3,1,0,shortest
620,25,56,graphml/AttMpls.graphml,2,1,clustered,0.6;-0.3,5,5,5,0,2,-1,-6,-1,-1,-6,0,shortest
619,25,56,graphml/AttMpls.graphml,2,1,clustered,0.6;-0.3,4,4,4,0,12,-1,-5,-1,-1,-5,0,shortest
618,25,56,graphml/AttMpls.graphml,2,1,clustered,0.6;-0.3,-1,-1,4,-5,0,-1,-5,-1,-1,-5,0,shortest
617,25,56,graphml/AttMpls.graphml,2,1,clustered,0.6;-0.3,3,7,3,0,0,3,0,3,3,0,0,shortest
616,25,56,graphml/AttMpls.graphml,2,1,clustered,0.6;-0.3,10,10,4,6,0,8,4,8,8,4,0,shortest
614,25,56,graphml/AttMpls.graphml,4,3,clustered,0.6;-0.3,16,16,3,13,0,9,6,9,9,6,0,shortest
611,25,56,graphml/AttMpls.graphml,2,1,clustered,0.6;-0.3,4,12,4,0,2,4,0,4,4,0,0,shortest
610,25,56,graphml/AttMpls.graphml,3,2,clustered,0.6;-0.3,3,3,3,0,2,3,0,3,3,0,2,shortest
609,25,56,graphml/AttMpls.graphml,3,2,clustered,0.6;-0.3,15,13,3,12,0,12,9,8,8,5,0,shortest
608,25,56,graphml/AttMpls.graphml,4,3,clustered,0.6;-0.3,27,37,4,23,2,21,17,21,21,17,0,shortest
607,25,56,graphml/AttMpls.graphml,2,1,clustered,0.6;-0.3,3,3,3,0,0,3,0,3,3,0,0,shortest
606,25,56,graphml/AttMpls.graphml,3,2,clustered,0.6;-0.3,7,7,3,4,4,10,7,14,14,11,2,shortest
605,25,56,graphml/AttMpls.graphml,2,1,clustered,0.6;-0.3,3,3,3,0,0,3,0,3,3,0,0,shortest
604,25,56,graphml/AttMpls.graphml,2,1,clustered,0.6;-0.3,11,3,3,8,8,3,0,3,3,0,0,shortest
601,25,56,graphml/AttMpls.graphml,2,1,clustered,0.6;-0.3,-1,-1,4,-5,20,-1,-5,-1,-1,-5,0,shortest
600,25,56,graphml/AttMpls.graphml,9,8,clustered,0.6;-0.3,4,4,2,2,0,4,2,4,4,2,0,shortest
598,25,56,graphml/AttMpls.graphml,3,2,clustered,0.6;-0.3,5,5,3,2,0,-1,-4,-1,-1,-4,0,shortest
597,25,56,graphml/AttMpls.graphml,2,1,clustered,0.6;-0.3,4,4,2,2,0,2,0,4,4,2,0,shortest
596,25,56,graphml/AttMpls.graphml,2,1,clustered,0.6;-0.3,2,2,2,0,0,2,0,2,2,0,0,shortest
595,25,56,graphml/AttMpls.graphml,3,2,clustered,0.6;-0.3,4,4,4,0,0,-1,-5,4,4,0,0,shortest
594,25,56,graphml/AttMpls.graphml,3,2,clustered,0.6;-0.3,12,10,4,8,22,-1,-5,-1,-1,-5,0,shortest
593,25,56,graphml/AttMpls.graphml,3,2,clustered,0.6;-0.3,3,3,3,0,0,3,0,3,3,0,0,shortest
591,25,56,graphml/AttMpls.graphml,3,2,clustered,0.6;-0.3,3,3,3,0,0,3,0,3,3,0,0,shortest
589,25,56,graphml/AttMpls.graphml,3,2,clustered,0.6;-0.3,11,15,3,8,0,-1,-4,-1,-1,-4,0,shortest
588,25,56,graphml/AttMpls.graphml,2,1,clustered,0.6;-0.3,5,5,5,0,2,5,0,5,5,0,0,shortest
587,25,56,graphml/AttMpls.graphml,2,1,clustered,0.6;-0.3,8,8,4,4,6,-1,-5,-1,-1,-5,0,shortest
586,25,56,graphml/AttMpls.graphml,3,2,clustered,0.6;-0.3,6,6,3,3,0,-1,-4,6,6,3,0,shortest
585,25,56,graphml/AttMpls.graphml,3,2,clustered,0.6;-0.3,8,8,3,5,8,-1,-4,6,6,3,4,shortest
584,25,56,graphml/AttMpls.graphml,2,1,clustered,0.6;-0.3,5,5,4,1,2,-1,-5,-1,-1,-5,0,shortest
583,25,56,graphml/AttMpls.graphml,3,2,clustered,0.6;-0.3,6,12,4,2,16,8,4,6,6,2,0,shortest
582,25,56,graphml/AttMpls.graphml,2,1,clustered,0.6;-0.3,3,17,2,1,4,2,0,2,2,0,2,shortest
581,25,56,graphml/AttMpls.graphml,4,3,clustered,0.6;-0.3,4,4,2,2,12,13,11,7,7,5,6,shortest
579,25,56,graphml/AttMpls.graphml,2,1,clustered,0.6;-0.3,4,20,4,0,0,4,0,4,4,0,0,shortest
578,25,56,graphml/AttMpls.graphml,4,3,clustered,0.6;-0.3,3,3,3,0,0,3,0,7,7,4,0,shortest
577,25,56,graphml/AttMpls.graphml,2,1,clustered,0.6;-0.3,-1,-1,4,-5,2,-1,-5,-1,-1,-5,0,shortest
576,25,56,graphml/AttMpls.graphml,4,3,clustered,0.6;-0.3,6,6,3,3,0,7,4,9,9,6,0,shortest
575,25,56,graphml/AttMpls.graphml,3,2,clustered,0.6;-0.3,3,3,3,0,2,3,0,3,3,0,0,shortest
574,25,56,graphml/AttMpls.graphml,2,1,clustered,0.6;-0.3,3,3,3,0,12,5,2,5,5,2,0,shortest
573,25,56,graphml/AttMpls.graphml,2,1,clustered,0.6;-0.3,-1,-1,4,-5,16,-1,-5,-1,-1,-5,0,shortest
572,25,56,graphml/AttMpls.graphml,5,4,clustered,0.6;-0.3,4,4,4,0,0,10,6,4,4,0,0,shortest
571,25,56,graphml/AttMpls.graphml,2,1,clustered,0.6;-0.3,3,7,2,1,26,2,0,2,2,0,0,shortest
570,25,56,graphml/AttMpls.graphml,4,3,clustered,0.6;-0.3,10,10,4,6,0,10,6,10,10,6,0,shortest
569,25,56,graphml/AttMpls.graphml,4,3,clustered,0.6;-0.3,3,3,3,0,0,3,0,3,3,0,0,shortest
568,25,56,graphml/AttMpls.graphml,2,1,clustered,0.6;-0.3,5,11,3,2,8,-1,-4,-1,-1,-4,0,shortest
567,25,56,graphml/AttMpls.graphml,9,8,clustered,0.6;-0.3,12,12,2,10,0,13,11,10,10,8,0,shortest
566,25,56,graphml/AttMpls.graphml,3,2,clustered,0.6;-0.3,17,15,4,13,24,-1,-5,-1,-1,-5,12,shortest
565,25,56,graphml/AttMpls.graphml,2,1,clustered,0.6;-0.3,3,7,3,0,0,3,0,3,3,0,0,shortest
564,25,56,graphml/AttMpls.graphml,2,1,clustered,0.6;-0.3,14,14,5,9,8,-1,-6,-1,-1,-6,0,shortest
563,25,56,graphml/AttMpls.graphml,5,4,clustered,0.6;-0.3,4,4,2,2,0,4,2,4,4,2,0,shortest
562,25,56,graphml/AttMpls.graphml,3,2,clustered,0.6;-0.3,6,6,3,3,8,10,7,10,14,7,2,shortest
561,25,56,graphml/AttMpls.graphml,3,2,clustered,0.6;-0.3,3,3,3,0,0,3,0,3,3,0,0,shortest
560,25,56,graphml/AttMpls.graphml,3,2,clustered,0.6;-0.3,2,2,2,0,8,2,0,2,2,0,4,shortest
558,25,56,graphml/AttMpls.graphml,4,3,clustered,0.6;-0.3,2,2,2,0,0,3,1,2,2,0,0,shortest
557,25,56,graphml/AttMpls.graphml,4,3,clustered,0.6;-0.3,2,2,2,0,0,2,0,2,2,0,0,shortest
556,25,56,graphml/AttMpls.graphml,2,1,clustered,0.6;-0.3,4,4,4,0,0,13,9,4,4,0,0,shortest
555,25,56,graphml/AttMpls.graphml,5,4,clustered,0.6;-0.3,5,5,2,3,0,5,3,5,5,3,0,shortest
554,25,56,graphml/AttMpls.graphml,2,1,clustered,0.6;-0.3,3,7,2,1,6,4,2,4,4,2,0,shortest
553,25,56,graphml/AttMpls.graphml,3,2,clustered,0.6;-0.3,13,13,3,10,4,9,6,9,9,6,2,shortest
551,25,56,graphml/AttMpls.graphml,3,2,clustered,0.6;-0.3,3,14,3,0,4,-1,-4,3,3,0,2,shortest
550,25,56,graphml/AttMpls.graphml,5,4,clustered,0.6;-0.3,-1,-1,3,-4,0,-1,-4,-1,-1,-4,0,shortest
549,25,56,graphml/AttMpls.graphml,4,3,clustered,0.6;-0.3,13,9,4,9,6,12,8,12,12,8,0,shortest
548,25,56,graphml/AttMpls.graphml,3,2,clustered,0.6;-0.3,6,6,5,1,10,-1,-6,-1,-1,-6,0,shortest
544,25,56,graphml/AttMpls.graphml,4,3,clustered,0.6;-0.3,11,11,3,8,0,9,6,11,11,8,0,shortest
543,25,56,graphml/AttMpls.graphml,5,4,clustered,0.6;-0.3,7,7,3,4,0,15,12,7,7,4,0,shortest
542,25,56,graphml/AttMpls.graphml,3,2,clustered,0.6;-0.3,3,3,3,0,0,3,0,3,3,0,0,shortest
540,25,56,graphml/AttMpls.graphml,2,1,clustered,0.6;-0.3,7,5,4,3,0,8,4,8,8,4,0,shortest
539,25,56,graphml/AttMpls.graphml,2,1,clustered,0.6;-0.3,9,9,5,4,2,12,7,12,12,7,0,shortest
538,25,56,graphml/AttMpls.graphml,5,4,clustered,0.6;-0.3,7,7,3,4,0,-1,-4,-1,-1,-4,0,shortest
537,25,56,graphml/AttMpls.graphml,3,2,clustered,0.6;-0.3,3,3,3,0,0,3,0,3,3,0,0,shortest
536,25,56,graphml/AttMpls.graphml,2,1,clustered,0.6;-0.3,3,5,3,0,0,3,0,3,3,0,0,shortest
535,25,56,graphml/AttMpls.graphml,2,1,clustered,0.6;-0.3,3,3,3,0,0,-1,-4,3,3,0,0,shortest
534,25,56,graphml/AttMpls.graphml,2,1,clustered,0.6;-0.3,14,22,5,9,6,-1,-6,-1,-1,-6,0,shortest
533,25,56,graphml/AttMpls.graphml,4,3,clustered,0.6;-0.3,7,7,3,4,0,3,0,7,7,4,0,shortest
532,25,56,graphml/AttMpls.graphml,2,1,clustered,0.6;-0.3,3,7,3,0,4,3,0,3,3,0,2,shortest
531,25,56,graphml/AttMpls.graphml,4,3,clustered,0.6;-0.3,12,12,4,8,6,14,10,14,14,10,0,shortest
530,25,56,graphml/AttMpls.graphml,2,1,clustered,0.6;-0.3,9,9,4,5,8,-1,-5,-1,-1,-5,0,shortest
529,25,56,graphml/AttMpls.graphml,2,1,clustered,0.6;-0.3,5,5,5,0,0,5,0,5,5,0,0,shortest
528,25,56,graphml/AttMpls.graphml,4,3,clustered,0.6;-0.3,3,3,3,0,0,17,14,3,3,0,0,shortest
527,25,56,graphml/AttMpls.graphml,2,1,clustered,0.6;-0.3,4,4,3,1,8,8,5,8,8,5,0,shortest
525,25,56,graphml/AttMpls.graphml,3,2,clustered,0.6;-0.3,21,19,4,17,4,-1,-5,-1,-1,-5,0,shortest
524,25,56,graphml/AttMpls.graphml,3,2,clustered,0.6;-0.3,29,29,5,24,0,21,16,13,13,8,0,shortest
522,25,56,graphml/AttMpls.graphml,3,2,clustered,0.6;-0.3,12,12,4,8,0,8,4,8,8,4,0,shortest
521,25,56,graphml/AttMpls.graphml,7,6,clustered,0.6;-0.3,7,7,2,5,4,2,0,2,2,0,0,shortest
519,25,56,graphml/AttMpls.graphml,5,4,clustered,0.6;-0.3,17,17,3,14,8,17,14,17,17,14,0,shortest
518,25,56,graphml/AttMpls.graphml,2,1,clustered,0.6;-0.3,2,2,2,0,0,4,2,4,4,2,0,shortest
517,25,56,graphml/AttMpls.graphml,2,1,clustered,0.6;-0.3,5,5,5,0,4,-1,-6,-1,-1,-6,0,shortest
514,25,56,graphml/AttMpls.graphml,3,2,clustered,0.6;-0.3,7,7,3,4,0,3,0,7,7,4,0,shortest
513,25,56,graphml/AttMpls.graphml,4,3,clustered,0.6;-0.3,11,9,3,8,16,-1,-4,-1,-1,-4,10,shortest
512,25,56,graphml/AttMpls.graphml,2,1,clustered,0.6;-0.3,11,11,3,8,2,3,0,5,5,2,0,shortest
511,25,56,graphml/AttMpls.graphml,2,1,clustered,0.6;-0.3,10,8,6,4,4,-1,-7,-1,-1,-7,0,shortest
510,25,56,graphml/AttMpls.graphml,4,3,clustered,0.6;-0.3,27,31,3,24,4,-1,-4,-1,-1,-4,0,shortest
509,25,56,graphml/AttMpls.graphml,2,1,clustered,0.6;-0.3,12,22,5,7,0,12,7,12,12,7,0,shortest
508,25,56,graphml/AttMpls.graphml,2,1,clustered,0.6;-0.3,-1,-1,6,-7,6,-1,-7,-1,-1,-7,0,shortest
507,25,56,graphml/AttMpls.graphml,2,1,clustered,0.6;-0.3,4,5,4,0,8,4,0,4,4,0,0,shortest
506,25,56,graphml/AttMpls.graphml,2,1,clustered,0.6;-0.3,3,3,3,0,12,5,2,5,5,2,0,shortest
505,25,56,graphml/AttMpls.graphml,5,4,clustered,0.6;-0.3,21,17,4,17,4,-1,-5,10,10,6,2,shortest
504,25,56,graphml/AttMpls.graphml,3,2,clustered,0.6;-0.3,2,2,2,0,8,2,0,2,2,0,4,shortest
503,25,56,graphml/AttMpls.graphml,2,1,clustered,0.6;-0.3,13,7,4,9,0,13,9,13,13,9,0,shortest
502,25,56,graphml/AttMpls.graphml,2,1,clustered,0.6;-0.3,3,11,3,0,0,3,0,3,3,0,0,shortest
501,25,56,graphml/AttMpls.graphml,5,4,clustered,0.6;-0.3,27,19,3,24,0,-1,-4,-1,-1,-4,0,shortest
499,25,56,graphml/AttMpls.graphml,5,4,clustered,0.6;-0.3,6,6,3,3,0,6,3,6,6,3,0,shortest
498,25,56,graphml/AttMpls.graphml,3,2,clustered,0.6;-0.3,8,6,3,5,0,-1,-4,-1,-1,-4,0,shortest
497,25,56,graphml/AttMpls.graphml,2,1,clustered,0.6;-0.3,12,12,4,8,22,8,4,8,8,4,4,shortest
496,25,56,graphml/AttMpls.graphml,2,1,clustered,0.6;-0.3,4,4,3,1,20,6,3,4,4,1,0,shortest
495,25,56,graphml/AttMpls.graphml,3,2,clustered,0.6;-0.3,3,3,3,0,16,3,0,3,3,0,0,shortest
494,25,56,graphml/AttMpls.graphml,3,2,clustered,0.6;-0.3,-1,-1,4,-5,0,-1,-5,-1,-1,-5,0,shortest
493,25,56,graphml/AttMpls.graphml,6,5,clustered,0.6;-0.3,9,9,3,6,10,12,9,18,18,15,0,shortest
492,25,56,graphml/AttMpls.graphml,3,2,clustered,0.6;-0.3,4,10,3,1,20,-1,-4,-1,-1,-4,0,shortest
491,25,56,graphml/AttMpls.graphml,3,2,clustered,0.6;-0.3,-1,-1,5,-6,0,-1,-6,-1,-1,-6,0,shortest
490,25,56,graphml/AttMpls.graphml,4,3,clustered,0.6;-0.3,3,3,3,0,0,-1,-4,3,3,0,0,shortest
488,25,56,graphml/AttMpls.graphml,3,2,clustered,0.6;-0.3,3,3,2,1,0,2,0,2,2,0,0,shortest
486,25,56,graphml/AttMpls.graphml,5,4,clustered,0.6;-0.3,2,2,2,0,0,2,0,2,2,0,0,shortest
485,25,56,graphml/AttMpls.graphml,5,4,clustered,0.6;-0.3,5,5,3,2,2,3,0,3,3,0,0,shortest
484,25,56,graphml/AttMpls.graphml,5,4,clustered,0.6;-0.3,11,11,4,7,2,11,7,11,11,7,0,shortest
483,25,56,graphml/AttMpls.graphml,2,1,clustered,0.6;-0.3,24,16,5,19,8,-1,-6,18,18,13,4,shortest
482,25,56,graphml/AttMpls.graphml,2,1,clustered,0.6;-0.3,2,2,2,0,14,2,0,2,2,0,0,shortest
481,25,56,graphml/AttMpls.graphml,4,3,clustered,0.6;-0.3,8,8,4,4,0,-1,-5,-1,-1,-5,0,shortest
480,25,56,graphml/AttMpls.graphml,2,1,clustered,0.6;-0.3,19,13,5,14,6,-1,-6,13,11,8,2,shortest
479,25,56,graphml/AttMpls.graphml,3,2,clustered,0.6;-0.3,25,31,4,21,2,11,7,17,17,13,0,shortest
478,25,56,graphml/AttMpls.graphml,4,3,clustered,0.6;-0.3,-1,-1,4,-5,4,-1,-5,-1,-1,-5,0,shortest
477,25,56,graphml/AttMpls.graphml,6,5,clustered,0.6;-0.3,10,10,3,7,12,16,13,16,16,13,0,shortest
476,25,56,graphml/AttMpls.graphml,4,3,clustered,0.6;-0.3,28,32,4,24,18,-1,-5,-1,-1,-5,0,shortest
475,25,56,graphml/AttMpls.graphml,5,4,clustered,0.6;-0.3,2,2,2,0,0,2,0,2,2,0,0,shortest
474,25,56,graphml/AttMpls.graphml,3,2,clustered,0.6;-0.3,3,15,2,1,0,3,1,3,3,1,0,shortest
473,25,56,graphml/AttMpls.graphml,2,1,clustered,0.6;-0.3,4,4,3,1,8,10,7,10,10,7,0,shortest
472,25,56,graphml/AttMpls.graphml,4,3,clustered,0.6;-0.3,8,8,3,5,0,9,6,11,11,8,0,shortest
471,25,56,graphml/AttMpls.graphml,2,1,clustered,0.6;-0.3,-1,-1,4,-5,2,-1,-5,-1,-1,-5,0,shortest
470,25,56,graphml/AttMpls.graphml,2,1,clustered,0.6;-0.3,4,4,4,0,0,10,6,4,4,0,0,shortest
469,25,56,graphml/AttMpls.graphml,3,2,clustered,0.6;-0.3,-1,-1,4,-5,18,-1,-5,-1,-1,-5,0,shortest
468,25,56,graphml/AttMpls.graphml,2,1,clustered,0.6;-0.3,12,12,5,7,0,14,9,14,14,9,0,shortest
467,25,56,graphml/AttMpls.graphml,2,1,clustered,0.6;-0.3,9,5,5,4,0,11,6,11,11,6,0,shortest
466,25,56,graphml/AttMpls.graphml,3,2,clustered,0.6;-0.3,9,9,3,6,8,-1,-4,-1,-1,-4,0,shortest
465,25,56,graphml/AttMpls.graphml,3,2,clustered,0.6;-0.3,3,3,2,1,0,3,1,3,3,1,0,shortest
464,25,56,graphml/AttMpls.graphml,4,3,clustered,0.6;-0.3,15,15,3,12,0,7,4,15,15,12,0,shortest
463,25,56,graphml/AttMpls.graphml,2,1,clustered,0.6;-0.3,8,6,4,4,0,-1,-5,-1,-1,-5,0,shortest
462,25,56,graphml/AttMpls.graphml,2,1,clustered,0.6;-0.3,4,10,3,1,0,4,1,4,4,1,0,shortest
461,25,56,graphml/AttMpls.graphml,2,1,clustered,0.6;-0.3,3,9,2,1,0,5,3,2,2,0,0,shortest
460,25,56,graphml/AttMpls.graphml,2,1,clustered,0.6;-0.3,4,4,4,0,0,10,6,4,4,0,0,shortest
459,25,56,graphml/AttMpls.graphml,2,1,clustered,0.6;-0.3,5,5,3,2,0,3,0,3,3,0,0,shortest
458,25,56,graphml/AttMpls.graphml,5,4,clustered,0.6;-0.3,3,3,2,1,0,3,1,3,3,1,0,shortest
457,25,56,graphml/AttMpls.graphml,2,1,clustered,0.6;-0.3,7,17,3,4,26,-1,-4,-1,-1,-4,0,shortest
456,25,56,graphml/AttMpls.graphml,2,1,clustered,0.6;-0.3,3,3,3,0,0,3,0,3,3,0,0,shortest
455,25,56,graphml/AttMpls.graphml,4,3,clustered,0.6;-0.3,2,2,2,0,0,2,0,2,2,0,0,shortest
454,25,56,graphml/AttMpls.graphml,6,5,clustered,0.6;-0.3,16,16,3,13,0,12,9,6,6,3,0,shortest
453,25,56,graphml/AttMpls.graphml,2,1,clustered,0.6;-0.3,6,6,3,3,0,5,2,5,5,2,0,shortest
452,25,56,graphml/AttMpls.graphml,3,2,clustered,0.6;-0.3,2,2,2,0,16,-1,-3,2,2,0,8,shortest
451,25,56,graphml/AttMpls.graphml,2,1,clustered,0.6;-0.3,8,6,4,4,0,6,2,6,6,2,0,shortest
450,25,56,graphml/AttMpls.graphml,2,1,clustered,0.6;-0.3,5,5,5,0,6,5,0,5,5,0,2,shortest
449,25,56,graphml/AttMpls.graphml,2,1,clustered,0.6;-0.3,4,4,4,0,0,4,0,4,4,0,0,shortest
448,25,56,graphml/AttMpls.graphml,2,1,clustered,0.6;-0.3,3,5,3,0,0,3,0,3,3,0,0,shortest
445,25,56,graphml/AttMpls.graphml,2,1,clustered,0.6;-0.3,16,16,2,14,4,2,0,2,2,0,2,shortest
443,25,56,graphml/AttMpls.graphml,2,1,clustered,0.6;-0.3,9,9,4,5,12,10,6,10,10,6,0,shortest
442,25,56,graphml/AttMpls.graphml,4,3,clustered,0.6;-0.3,5,5,3,2,18,5,2,5,5,2,0,shortest
441,25,56,graphml/AttMpls.graphml,2,1,clustered,0.6;-0.3,8,8,6,2,0,-1,-7,-1,-1,-7,0,shortest
440,25,56,graphml/AttMpls.graphml,3,2,clustered,0.6;-0.3,-1,-1,6,-7,4,-1,-7,-1,-1,-7,2,shortest
439,25,56,graphml/AttMpls.graphml,3,2,clustered,0.6;-0.3,3,3,3,0,0,3,0,3,3,0,0,shortest
438,25,56,graphml/AttMpls.graphml,5,4,clustered,0.6;-0.3,7,7,3,4,10,3,0,7,7,4,0,shortest
437,25,56,graphml/AttMpls.graphml,2,1,clustered,0.6;-0.3,18,14,4,14,6,-1,-5,13,11,9,2,shortest
436,25,56,graphml/AttMpls.graphml,2,1,clustered,0.6;-0.3,4,4,4,0,0,11,7,4,4,0,0,shortest
434,25,56,graphml/AttMpls.graphml,3,2,clustered,0.6;-0.3,3,3,3,0,4,3,0,3,3,0,0,shortest
433,25,56,graphml/AttMpls.graphml,3,2,clustered,0.6;-0.3,4,4,3,1,4,12,9,12,12,9,0,shortest
431,25,56,graphml/AttMpls.graphml,2,1,clustered,0.6;-0.3,4,4,4,0,6,-1,-5,-1,-1,-5,2,shortest
430,25,56,graphml/AttMpls.graphml,2,1,clustered,0.6;-0.3,-1,-1,5,-6,0,-1,-6,-1,-1,-6,0,shortest
429,25,56,graphml/AttMpls.graphml,2,1,clustered,0.6;-0.3,3,3,3,0,14,3,0,3,3,0,0,shortest
428,25,56,graphml/AttMpls.graphml,3,2,clustered,0.6;-0.3,7,8,2,5,0,5,3,5,5,3,0,shortest
427,25,56,graphml/AttMpls.graphml,3,2,clustered,0.6;-0.3,5,5,3,2,0,4,1,4,4,1,0,shortest
426,25,56,graphml/AttMpls.graphml,2,1,clustered,0.6;-0.3,3,7,2,1,0,2,0,2,2,0,0,shortest
425,25,56,graphml/AttMpls.graphml,2,1,clustered,0.6;-0.3,12,22,5,7,0,12,7,12,12,7,0,shortest
424,25,56,graphml/AttMpls.graphml,3,2,clustered,0.6;-0.3,3,3,3,0,0,3,0,5,5,2,0,shortest
423,25,56,graphml/AttMpls.graphml,3,2,clustered,0.6;-0.3,-1,-1,3,-4,0,-1,-4,-1,-1,-4,0,shortest
422,25,56,graphml/AttMpls.graphml,4,3,clustered,0.6;-0.3,2,2,2,0,0,2,0,2,2,0,0,shortest
421,25,56,graphml/AttMpls.graphml,4,3,clustered,0.6;-0.3,12,12,2,10,0,2,0,2,2,0,0,shortest
420,25,56,graphml/AttMpls.graphml,3,2,clustered,0.6;-0.3,2,2,2,0,0,11,9,2,2,0,0,shortest
419,25,56,graphml/AttMpls.graphml,5,4,clustered,0.6;-0.3,5,11,3,2,0,5,2,9,9,6,0,shortest
418,25,56,graphml/AttMpls.graphml,2,1,clustered,0.6;-0.3,6,4,4,2,0,6,2,6,6,2,0,shortest
417,25,56,graphml/AttMpls.graphml,4,3,clustered,0.6;-0.3,2,2,2,0,18,2,0,2,2,0,0,shortest
416,25,56,graphml/AttMpls.graphml,4,3,clustered,0.6;-0.3,9,9,3,6,0,6,3,9,9,6,0,shortest
415,25,56,graphml/AttMpls.graphml,2,1,clustered,0.6;-0.3,18,18,4,14,8,-1,-5,-1,-1,-5,0,shortest
414,25,56,graphml/AttMpls.graphml,3,2,clustered,0.6;-0.3,2,2,2,0,0,2,0,2,2,0,0,shortest
413,25,56,graphml/AttMpls.graphml,2,1,clustered,0.6;-0.3,8,6,5,3,4,-1,-6,-1,-1,-6,0,shortest
412,25,56,graphml/AttMpls.graphml,3,2,clustered,0.6;-0.3,12,16,5,7,0,-1,-6,-1,-1,-6,0,shortest
411,25,56,graphml/AttMpls.graphml,4,3,clustered,0.6;-0.3,11,11,3,8,8,7,4,7,7,4,2,shortest
409,25,56,graphml/AttMpls.graphml,3,2,clustered,0.6;-0.3,3,3,3,0,4,3,0,3,3,0,0,shortest
408,25,56,graphml/AttMpls.graphml,3,2,clustered,0.6;-0.3,4,4,4,0,0,4,0,4,4,0,0,shortest
407,25,56,graphml/AttMpls.graphml,2,1,clustered,0.6;-0.3,3,3,3,0,0,5,2,5,5,2,0,shortest
406,25,56,graphml/AttMpls.graphml,4,3,clustered,0.6;-0.3,5,5,3,2,0,5,2,5,5,2,0,shortest
405,25,56,graphml/AttMpls.graphml,4,3,clustered,0.6;-0.3,4,4,2,2,16,4,2,4,4,2,0,shortest
404,25,56,graphml/AttMpls.graphml,3,2,clustered,0.6;-0.3,21,21,4,17,0,17,13,5,5,1,0,shortest
403,25,56,graphml/AttMpls.graphml,4,3,clustered,0.6;-0.3,3,3,3,0,6,3,0,3,3,0,2,shortest
402,25,56,graphml/AttMpls.graphml,3,2,clustered,0.6;-0.3,4,4,4,0,4,4,0,4,4,0,0,shortest
401,25,56,graphml/AttMpls.graphml,2,1,clustered,0.6;-0.3,6,6,4,2,0,8,4,8,8,4,0,shortest
400,25,56,graphml/AttMpls.graphml,2,1,clustered,0.6;-0.3,3,3,3,0,0,3,0,3,3,0,0,shortest
399,25,56,graphml/AttMpls.graphml,3,2,clustered,0.6;-0.3,11,15,3,8,0,-1,-4,-1,-1,-4,0,shortest
398,25,56,graphml/AttMpls.graphml,2,1,clustered,0.6;-0.3,-1,-1,5,-6,0,-1,-6,-1,-1,-6,0,shortest
397,25,56,graphml/AttMpls.graphml,2,1,clustered,0.6;-0.3,16,16,4,12,0,-1,-5,-1,-1,-5,0,shortest
396,25,56,graphml/AttMpls.graphml,2,1,clustered,0.6;-0.3,11,11,4,7,12,-1,-5,-1,-1,-5,0,shortest
395,25,56,graphml/AttMpls.graphml,2,1,clustered,0.6;-0.3,3,3,2,1,6,3,1,3,3,1,0,shortest
394,25,56,graphml/AttMpls.graphml,5,4,clustered,0.6;-0.3,2,2,2,0,8,2,0,2,2,0,0,shortest
393,25,56,graphml/AttMpls.graphml,3,2,clustered,0.6;-0.3,11,11,4,7,2,11,7,11,11,7,0,shortest
392,25,56,graphml/AttMpls.graphml,4,3,clustered,0.6;-0.3,16,16,4,12,0,12,8,12,12,8,0,shortest
390,25,56,graphml/AttMpls.graphml,2,1,clustered,0.6;-0.3,7,7,5,2,0,-1,-6,-1,-1,-6,0,shortest
389,25,56,graphml/AttMpls.graphml,2,1,clustered,0.6;-0.3,8,8,4,4,0,8,4,8,8,4,0,shortest
388,25,56,graphml/AttMpls.graphml,2,1,clustered,0.6;-0.3,3,3,3,0,0,3,0,3,3,0,0,shortest
387,25,56,graphml/AttMpls.graphml,2,1,clustered,0.6;-0.3,3,3,3,0,8,3,0,3,3,0,4,shortest
386,25,56,graphml/AttMpls.graphml,2,1,clustered,0.6;-0.3,3,3,3,0,0,3,0,3,3,0,0,shortest
383,25,56,graphml/AttMpls.graphml,3,2,clustered,0.6;-0.3,21,13,4,17,0,13,9,13,13,9,0,shortest
382,25,56,graphml/AttMpls.graphml,3,2,clustered,0.6;-0.3,13,13,5,8,4,-1,-6,-1,-1,-6,0,shortest
381,25,56,graphml/AttMpls.graphml,3,2,clustered,0.6;-0.3,3,3,3,0,0,8,5,8,8,5,0,shortest
380,25,56,graphml/AttMpls.graphml,4,3,clustered,0.6;-0.3,6,6,3,3,0,5,2,9,9,6,0,shortest
379,25,56,graphml/AttMpls.graphml,5,4,clustered,0.6;-0.3,4,4,3,1,0,14,11,4,4,1,0,shortest
378,25,56,graphml/AttMpls.graphml,2,1,clustered,0.6;-0.3,10,8,4,6,0,8,4,8,8,4,0,shortest
377,25,56,graphml/AttMpls.graphml,5,4,clustered,0.6;-0.3,4,5,4,0,2,20,16,20,20,16,0,shortest
376,25,56,graphml/AttMpls.graphml,5,4,clustered,0.6;-0.3,8,8,3,5,0,-1,-4,8,8,5,0,shortest
375,25,56,graphml/AttMpls.graphml,3,2,clustered,0.6;-0.3,4,4,2,2,0,5,3,5,5,3,0,shortest
374,25,56,graphml/AttMpls.graphml,2,1,clustered,0.6;-0.3,3,3,3,0,0,3,0,3,3,0,0,shortest
373,25,56,graphml/AttMpls.graphml,2,1,clustered,0.6;-0.3,5,11,3,2,8,3,0,3,3,0,0,shortest
372,25,56,graphml/AttMpls.graphml,2,1,clustered,0.6;-0.3,12,12,4,8,0,8,4,8,8,4,0,shortest
371,25,56,graphml/AttMpls.graphml,2,1,clustered,0.6;-0.3,-1,-1,4,-5,4,-1,-5,-1,-1,-5,0,shortest
370,25,56,graphml/AttMpls.graphml,4,3,clustered,0.6;-0.3,9,9,4,5,0,6,2,12,12,8,0,shortest
369,25,56,graphml/AttMpls.graphml,3,2,clustered,0.6;-0.3,9,9,4,5,0,18,14,9,9,5,0,shortest
368,25,56,graphml/AttMpls.graphml,4,3,clustered,0.6;-0.3,13,13,4,9,0,13,9,13,13,9,0,shortest
367,25,56,graphml/AttMpls.graphml,2,1,clustered,0.6;-0.3,3,9,3,0,8,3,0,3,3,0,0,shortest
365,25,56,graphml/AttMpls.graphml,2,1,clustered,0.6;-0.3,6,6,3,3,0,6,3,6,6,3,0,shortest
364,25,56,graphml/AttMpls.graphml,2,1,clustered,0.6;-0.3,2,2,2,0,0,6,4,2,2,0,0,shortest
363,25,56,graphml/AttMpls.graphml,5,4,clustered,0.6;-0.3,5,9,4,1,2,13,9,13,13,9,0,shortest
362,25,56,graphml/AttMpls.graphml,2,1,clustered,0.6;-0.3,4,4,4,0,0,4,0,4,4,0,0,shortest
359,25,56,graphml/AttMpls.graphml,4,3,clustered,0.6;-0.3,2,2,2,0,2,2,0,2,2,0,0,shortest
358,25,56,graphml/AttMpls.graphml,2,1,clustered,0.6;-0.3,4,6,4,0,4,-1,-5,-1,-1,-5,0,shortest
357,25,56,graphml/AttMpls.graphml,3,2,clustered,0.6;-0.3,6,4,3,3,0,4,1,4,4,1,0,shortest
356,25,56,graphml/AttMpls.graphml,4,3,clustered,0.6;-0.3,2,2,2,0,2,2,0,2,2,0,0,shortest
354,25,56,graphml/AttMpls.graphml,3,2,clustered,0.6;-0.3,8,8,3,5,0,5,2,5,5,2,0,shortest
353,25,56,graphml/AttMpls.graphml,2,1,clustered,0.6;-0.3,5,5,5,0,6,5,0,5,5,0,2,shortest
352,25,56,graphml/AttMpls.graphml,2,1,clustered,0.6;-0.3,-1,-1,4,-5,0,-1,-5,-1,-1,-5,0,shortest
351,25,56,graphml/AttMpls.graphml,4,3,clustered,0.6;-0.3,16,14,3,13,4,14,11,14,14,11,0,shortest
350,25,56,graphml/AttMpls.graphml,4,3,clustered,0.6;-0.3,-1,-1,3,-4,6,-1,-4,-1,-1,-4,0,shortest
349,25,56,graphml/AttMpls.graphml,2,1,clustered,0.6;-0.3,3,3,3,0,0,3,0,3,3,0,0,shortest
348,25,56,graphml/AttMpls.graphml,3,2,clustered,0.6;-0.3,15,15,4,11,0,9,5,15,15,11,0,shortest
347,25,56,graphml/AttMpls.graphml,2,1,clustered,0.6;-0.3,3,3,3,0,0,3,0,3,3,0,0,shortest
345,25,56,graphml/AttMpls.graphml,2,1,clustered,0.6;-0.3,7,7,3,4,0,7,4,7,7,4,0,shortest
343,25,56,graphml/AttMpls.graphml,3,2,clustered,0.6;-0.3,12,12,3,9,10,12,9,12,12,9,0,shortest
342,25,56,graphml/AttMpls.graphml,5,4,clustered,0.6;-0.3,2,2,2,0,14,4,2,4,4,2,0,shortest
341,25,56,graphml/AttMpls.graphml,2,1,clustered,0.6;-0.3,12,12,3,9,12,-1,-4,-1,-1,-4,0,shortest
340,25,56,graphml/AttMpls.graphml,3,2,clustered,0.6;-0.3,10,10,2,8,12,2,0,2,2,0,4,shortest
338,25,56,graphml/AttMpls.graphml,4,3,clustered,0.6;-0.3,7,7,3,4,0,3,0,7,7,4,0,shortest
337,25,56,graphml/AttMpls.graphml,4,3,clustered,0.6;-0.3,5,5,2,3,0,3,1,5,5,3,0,shortest
334,25,56,graphml/AttMpls.graphml,3,2,clustered,0.6;-0.3,7,15,4,3,20,-1,-5,-1,-1,-5,0,shortest
333,25,56,graphml/AttMpls.graphml,2,1,clustered,0.6;-0.3,4,4,4,0,4,4,0,4,4,0,0,shortest
330,25,56,graphml/AttMpls.graphml,5,4,clustered,0.6;-0.3,6,6,2,4,2,19,17,6,6,4,0,shortest
329,25,56,graphml/AttMpls.graphml,3,2,clustered,0.6;-0.3,2,2,2,0,0,2,0,2,2,0,0,shortest
328,25,56,graphml/AttMpls.graphml,2,1,clustered,0.6;-0.3,3,3,3,0,0,3,0,3,3,0,0,shortest
327,25,56,graphml/AttMpls.graphml,2,1,clustered,0.6;-0.3,5,5,5,0,0,5,0,5,5,0,0,shortest
326,25,56,graphml/AttMpls.graphml,4,3,clustered,0.6;-0.3,2,2,2,0,2,2,0,2,2,0,0,shortest
324,25,56,graphml/AttMpls.graphml,3,2,clustered,0.6;-0.3,16,14,5,11,4,-1,-6,14,14,9,2,shortest
323,25,56,graphml/AttMpls.graphml,4,3,clustered,0.6;-0.3,12,12,4,8,0,12,8,12,12,8,0,shortest
322,25,56,graphml/AttMpls.graphml,3,2,clustered,0.6;-0.3,9,9,4,5,16,-1,-5,-1,-1,-5,0,shortest
321,25,56,graphml/AttMpls.graphml,2,1,clustered,0.6;-0.3,5,5,4,1,12,8,4,8,8,4,0,shortest
320,25,56,graphml/AttMpls.graphml,3,2,clustered,0.6;-0.3,6,6,4,2,0,6,2,4,4,0,0,shortest
319,25,56,graphml/AttMpls.graphml,5,4,clustered,0.6;-0.3,7,7,3,4,0,-1,-4,-1,-1,-4,0,shortest
318,25,56,graphml/AttMpls.graphml,2,1,clustered,0.6;-0.3,3,3,3,0,0,3,0,3,3,0,0,shortest
317,25,56,graphml/AttMpls.graphml,3,2,clustered,0.6;-0.3,13,11,4,9,6,-1,-5,-1,-1,-5,2,shortest
316,25,56,graphml/AttMpls.graphml,3,2,clustered,0.6;-0.3,4,4,4,0,0,4,0,4,4,0,0,shortest
315,25,56,graphml/AttMpls.graphml,4,3,clustered,0.6;-0.3,7,13,3,4,0,3,0,7,7,4,0,shortest
314,25,56,graphml/AttMpls.graphml,2,1,clustered,0.6;-0.3,9,9,4,5,12,-1,-5,-1,-1,-5,0,shortest
313,25,56,graphml/AttMpls.graphml,2,1,clustered,0.6;-0.3,6,6,2,4,0,2,0,2,2,0,0,shortest
312,25,56,graphml/AttMpls.graphml,3,2,clustered,0.6;-0.3,2,2,2,0,2,2,0,2,2,0,2,shortest
311,25,56,graphml/AttMpls.graphml,2,1,clustered,0.6;-0.3,11,9,4,7,12,8,4,8,8,4,0,shortest
310,25,56,graphml/AttMpls.graphml,5,4,clustered,0.6;-0.3,3,17,3,0,14,3,0,3,3,0,0,shortest
309,25,56,graphml/AttMpls.graphml,4,3,clustered,0.6;-0.3,8,6,4,4,0,-1,-5,-1,-1,-5,0,shortest
308,25,56,graphml/AttMpls.graphml,4,3,clustered,0.6;-0.3,12,14,4,8,6,-1,-5,-1,-1,-5,0,shortest
306,25,56,graphml/AttMpls.graphml,2,1,clustered,0.6;-0.3,3,9,3,0,14,3,0,5,5,2,0,shortest
305,25,56,graphml/AttMpls.graphml,3,2,clustered,0.6;-0.3,2,2,2,0,0,2,0,2,2,0,0,shortest
304,25,56,graphml/AttMpls.graphml,4,3,clustered,0.6;-0.3,4,8,3,1,4,-1,-4,-1,-1,-4,0,shortest
303,25,56,graphml/AttMpls.graphml,3,2,clustered,0.6;-0.3,8,14,4,4,0,-1,-5,-1,-1,-5,0,shortest
302,25,56,graphml/AttMpls.graphml,5,4,clustered,0.6;-0.3,-1,-1,4,-5,2,-1,-5,-1,-1,-5,0,shortest
301,25,56,graphml/AttMpls.graphml,2,1,clustered,0.6;-0.3,2,2,2,0,0,4,2,4,4,2,0,shortest
300,25,56,graphml/AttMpls.graphml,3,2,clustered,0.6;-0.3,8,8,3,5,0,8,5,8,8,5,0,shortest
299,25,56,graphml/AttMpls.graphml,4,3,clustered,0.6;-0.3,-1,-1,3,-4,12,-1,-4,8,8,5,6,shortest
298,25,56,graphml/AttMpls.graphml,2,1,clustered,0.6;-0.3,4,8,3,1,12,-1,-4,-1,-1,-4,0,shortest
297,25,56,graphml/AttMpls.graphml,3,2,clustered,0.6;-0.3,5,5,3,2,0,3,0,5,5,2,0,shortest
296,25,56,graphml/AttMpls.graphml,2,1,clustered,0.6;-0.3,4,4,4,0,0,8,4,8,8,4,0,shortest
295,25,56,graphml/AttMpls.graphml,3,2,clustered,0.6;-0.3,11,11,3,8,8,-1,-4,21,21,18,6,shortest
294,25,56,graphml/AttMpls.graphml,4,3,clustered,0.6;-0.3,8,8,3,5,0,10,7,6,6,3,0,shortest
293,25,56,graphml/AttMpls.graphml,3,2,clustered,0.6;-0.3,16,17,4,12,2,-1,-5,-1,-1,-5,2,shortest
292,25,56,graphml/AttMpls.graphml,5,4,clustered,0.6;-0.3,2,2,2,0,2,4,2,4,4,2,0,shortest
291,25,56,graphml/AttMpls.graphml,3,2,clustered,0.6;-0.3,-1,-1,4,-5,4,-1,-5,-1,-1,-5,0,shortest
290,25,56,graphml/AttMpls.graphml,2,1,clustered,0.6;-0.3,-1,-1,4,-5,0,-1,-5,-1,-1,-5,0,shortest
289,25,56,graphml/AttMpls.graphml,2,1,clustered,0.6;-0.3,3,5,3,0,0,3,0,3,3,0,0,shortest
288,25,56,graphml/AttMpls.graphml,3,2,clustered,0.6;-0.3,13,11,3,10,4,3,0,5,5,2,0,shortest
287,25,56,graphml/AttMpls.graphml,3,2,clustered,0.6;-0.3,14,10,4,10,0,10,6,10,10,6,0,shortest
286,25,56,graphml/AttMpls.graphml,6,5,clustered,0.6;-0.3,3,9,3,0,0,3,0,3,3,0,0,shortest
285,25,56,graphml/AttMpls.graphml,6,5,clustered,0.6;-0.3,13,13,3,10,12,23,20,23,23,20,0,shortest
284,25,56,graphml/AttMpls.graphml,3,2,clustered,0.6;-0.3,3,9,3,0,0,3,0,3,3,0,0,shortest
283,25,56,graphml/AttMpls.graphml,2,1,clustered,0.6;-0.3,-1,-1,5,-6,12,-1,-6,-1,-1,-6,0,shortest
282,25,56,graphml/AttMpls.graphml,2,1,clustered,0.6;-0.3,6,6,3,3,14,7,4,7,7,4,0,shortest
281,25,56,graphml/AttMpls.graphml,5,4,clustered,0.6;-0.3,15,15,2,13,2,3,1,3,3,1,0,shortest
280,25,56,graphml/AttMpls.graphml,4,3,clustered,0.6;-0.3,12,12,4,8,6,12,8,12,12,8,2,shortest
279,25,56,graphml/AttMpls.graphml,3,2,clustered,0.6;-0.3,3,9,2,1,0,3,1,3,3,1,0,shortest
278,25,56,graphml/AttMpls.graphml,3,2,clustered,0.6;-0.3,10,10,5,5,4,18,13,10,10,5,2,shortest
277,25,56,graphml/AttMpls.graphml,2,1,clustered,0.6;-0.3,15,21,4,11,2,9,5,9,9,5,0,shortest
276,25,56,graphml/AttMpls.graphml,5,4,clustered,0.6;-0.3,20,20,5,15,0,-1,-6,-1,-1,-6,0,shortest
275,25,56,graphml/AttMpls.graphml,5,4,clustered,0.6;-0.3,29,29,4,25,0,-1,-5,-1,-1,-5,0,shortest
274,25,56,graphml/AttMpls.graphml,3,2,clustered,0.6;-0.3,-1,-1,6,-7,2,-1,-7,-1,-1,-7,0,shortest
273,25,56,graphml/AttMpls.graphml,2,1,clustered,0.6;-0.3,-1,-1,3,-4,0,-1,-4,-1,-1,-4,0,shortest
270,25,56,graphml/AttMpls.graphml,3,2,clustered,0.6;-0.3,11,9,4,7,16,-1,-5,-1,-1,-5,0,shortest
269,25,56,graphml/AttMpls.graphml,3,2,clustered,0.6;-0.3,3,3,3,0,0,3,0,3,3,0,0,shortest
268,25,56,graphml/AttMpls.graphml,2,1,clustered,0.6;-0.3,3,3,3,0,8,3,0,3,3,0,0,shortest
267,25,56,graphml/AttMpls.graphml,3,2,clustered,0.6;-0.3,3,3,2,1,0,3,1,3,3,1,0,shortest
266,25,56,graphml/AttMpls.graphml,3,2,clustered,0.6;-0.3,5,9,2,3,0,5,3,5,5,3,0,shortest
265,25,56,graphml/AttMpls.graphml,2,1,clustered,0.6;-0.3,5,5,5,0,4,5,0,5,5,0,0,shortest
264,25,56,graphml/AttMpls.graphml,3,2,clustered,0.6;-0.3,14,14,4,10,0,4,0,12,12,8,0,shortest
263,25,56,graphml/AttMpls.graphml,4,3,clustered,0.6;-0.3,8,8,3,5,0,14,11,8,8,5,0,shortest
261,25,56,graphml/AttMpls.graphml,2,1,clustered,0.6;-0.3,19,17,5,14,14,-1,-6,-1,-1,-6,0,shortest
258,25,56,graphml/AttMpls.graphml,4,3,clustered,0.6;-0.3,9,9,2,7,12,5,3,7,7,5,6,shortest
257,25,56,graphml/AttMpls.graphml,4,3,clustered,0.6;-0.3,33,33,5,28,0,19,14,27,27,22,0,shortest
256,25,56,graphml/AttMpls.graphml,3,2,clustered,0.6;-0.3,12,11,4,8,8,9,5,9,9,5,0,shortest
255,25,56,graphml/AttMpls.graphml,2,1,clustered,0.6;-0.3,10,4,4,6,26,6,2,6,6,2,0,shortest
253,25,56,graphml/AttMpls.graphml,3,2,clustered,0.6;-0.3,6,6,4,2,0,-1,-5,-1,-1,-5,0,shortest
252,25,56,graphml/AttMpls.graphml,3,2,clustered,0.6;-0.3,4,4,4,0,0,5,1,9,9,5,0,shortest
251,25,56,graphml/AttMpls.graphml,2,1,clustered,0.6;-0.3,5,5,5,0,6,5,0,5,5,0,2,shortest
250,25,56,graphml/AttMpls.graphml,4,3,clustered,0.6;-0.3,19,17,5,14,0,-1,-6,-1,-1,-6,0,shortest
248,25,56,graphml/AttMpls.graphml,6,5,clustered,0.6;-0.3,3,3,3,0,0,3,0,5,5,2,0,shortest
247,25,56,graphml/AttMpls.graphml,3,2,clustered,0.6;-0.3,3,3,3,0,2,3,0,3,3,0,2,shortest
245,25,56,graphml/AttMpls.graphml,3,2,clustered,0.6;-0.3,16,12,5,11,0,12,7,12,12,7,0,shortest
244,25,56,graphml/AttMpls.graphml,3,2,clustered,0.6;-0.3,3,3,2,1,0,3,1,3,3,1,0,shortest
243,25,56,graphml/AttMpls.graphml,2,1,clustered,0.6;-0.3,10,14,4,6,2,4,0,10,10,6,0,shortest
242,25,56,graphml/AttMpls.graphml,2,1,clustered,0.6;-0.3,-1,-1,5,-6,0,-1,-6,-1,-1,-6,0,shortest
241,25,56,graphml/AttMpls.graphml,2,1,clustered,0.6;-0.3,12,10,4,8,26,-1,-5,-1,-1,-5,0,shortest
239,25,56,graphml/AttMpls.graphml,3,2,clustered,0.6;-0.3,3,3,3,0,0,3,0,3,3,0,0,shortest
238,25,56,graphml/AttMpls.graphml,4,3,clustered,0.6;-0.3,2,2,2,0,0,7,5,2,2,0,0,shortest
237,25,56,graphml/AttMpls.graphml,3,2,clustered,0.6;-0.3,15,13,4,11,8,-1,-5,13,13,9,4,shortest
236,25,56,graphml/AttMpls.graphml,2,1,clustered,0.6;-0.3,3,5,3,0,4,3,0,7,7,4,0,shortest
235,25,56,graphml/AttMpls.graphml,2,1,clustered,0.6;-0.3,14,14,5,9,0,8,3,8,8,3,0,shortest
234,25,56,graphml/AttMpls.graphml,2,1,clustered,0.6;-0.3,18,18,4,14,0,10,6,10,10,6,0,shortest
233,25,56,graphml/AttMpls.graphml,2,1,clustered,0.6;-0.3,3,3,3,0,12,3,0,3,3,0,0,shortest
231,25,56,graphml/AttMpls.graphml,4,3,clustered,0.6;-0.3,4,4,4,0,0,8,4,4,4,0,0,shortest
230,25,56,graphml/AttMpls.graphml,2,1,clustered,0.6;-0.3,2,2,2,0,0,2,0,2,2,0,0,shortest
228,25,56,graphml/AttMpls.graphml,2,1,clustered,0.6;-0.3,11,11,4,7,0,-1,-5,-1,-1,-5,0,shortest
227,25,56,graphml/AttMpls.graphml,2,1,clustered,0.6;-0.3,16,12,6,10,2,-1,-7,-1,-1,-7,0,shortest
226,25,56,graphml/AttMpls.graphml,3,2,clustered,0.6;-0.3,7,7,3,4,8,3,0,3,3,0,2,shortest
225,25,56,graphml/AttMpls.graphml,3,2,clustered,0.6;-0.3,7,5,4,3,0,8,4,8,8,4,0,shortest
224,25,56,graphml/AttMpls.graphml,2,1,clustered,0.6;-0.3,3,3,3,0,0,-1,-4,3,3,0,0,shortest
223,25,56,graphml/AttMpls.graphml,2,1,clustered,0.6;-0.3,3,3,3,0,0,3,0,3,3,0,0,shortest
222,25,56,graphml/AttMpls.graphml,3,2,clustered,0.6;-0.3,4,4,2,2,14,4,2,4,4,2,14,shortest
221,25,56,graphml/AttMpls.graphml,4,3,clustered,0.6;-0.3,16,16,4,12,0,6,2,16,16,12,0,shortest
218,25,56,graphml/AttMpls.graphml,4,3,clustered,0.6;-0.3,4,4,4,0,0,10,6,4,4,0,0,shortest
217,25,56,graphml/AttMpls.graphml,3,2,clustered,0.6;-0.3,-1,-1,4,-5,8,-1,-5,-1,-1,-5,4,shortest
216,25,56,graphml/AttMpls.graphml,4,3,clustered,0.6;-0.3,5,5,3,2,4,5,2,3,3,0,2,shortest
214,25,56,graphml/AttMpls.graphml,4,3,clustered,0.6;-0.3,7,7,2,5,0,7,5,7,7,5,0,shortest
213,25,56,graphml/AttMpls.graphml,4,3,clustered,0.6;-0.3,7,7,3,4,0,3,0,7,7,4,0,shortest
212,25,56,graphml/AttMpls.graphml,4,3,clustered,0.6;-0.3,2,2,2,0,12,7,5,2,2,0,0,shortest
211,25,56,graphml/AttMpls.graphml,4,3,clustered,0.6;-0.3,4,4,2,2,0,10,8,4,4,2,0,shortest
210,25,56,graphml/AttMpls.graphml,4,3,clustered,0.6;-0.3,19,19,5,14,0,13,8,13,13,8,0,shortest
209,25,56,graphml/AttMpls.graphml,2,1,clustered,0.6;-0.3,-1,-1,5,-6,0,-1,-6,-1,-1,-6,0,shortest
208,25,56,graphml/AttMpls.graphml,5,4,clustered,0.6;-0.3,11,11,3,8,8,-1,-4,-1,-1,-4,0,shortest
207,25,56,graphml/AttMpls.graphml,3,2,clustered,0.6;-0.3,-1,-1,5,-6,4,-1,-6,-1,-1,-6,0,shortest
206,25,56,graphml/AttMpls.graphml,4,3,clustered,0.6;-0.3,-1,-1,6,-7,0,-1,-7,-1,-1,-7,0,shortest
205,25,56,graphml/AttMpls.graphml,3,2,clustered,0.6;-0.3,-1,-1,6,-7,0,-1,-7,-1,-1,-7,0,shortest
204,25,56,graphml/AttMpls.graphml,2,1,clustered,0.6;-0.3,6,6,4,2,10,6,2,6,6,2,0,shortest
203,25,56,graphml/AttMpls.graphml,7,6,clustered,0.6;-0.3,7,11,3,4,0,11,8,9,9,6,0,shortest
202,25,56,graphml/AttMpls.graphml,2,1,clustered,0.6;-0.3,10,8,6,4,4,-1,-7,-1,-1,-7,0,shortest
198,25,56,graphml/AttMpls.graphml,5,4,clustered,0.6;-0.3,2,2,2,0,0,2,0,2,2,0,0,shortest
197,25,56,graphml/AttMpls.graphml,2,1,clustered,0.6;-0.3,6,4,3,3,12,8,5,8,16,5,8,shortest
196,25,56,graphml/AttMpls.graphml,4,3,clustered,0.6;-0.3,5,9,2,3,12,-1,-3,6,6,4,0,shortest
195,25,56,graphml/AttMpls.graphml,4,3,clustered,0.6;-0.3,6,7,3,3,0,7,4,3,3,0,0,shortest
194,25,56,graphml/AttMpls.graphml,4,3,clustered,0.6;-0.3,2,2,2,0,2,2,0,2,2,0,0,shortest
192,25,56,graphml/AttMpls.graphml,2,1,clustered,0.6;-0.3,-1,-1,6,-7,6,-1,-7,-1,-1,-7,0,shortest
191,25,56,graphml/AttMpls.graphml,3,2,clustered,0.6;-0.3,31,32,4,27,2,9,5,15,15,11,0,shortest
190,25,56,graphml/AttMpls.graphml,4,3,clustered,0.6;-0.3,2,2,2,0,0,2,0,2,2,0,0,shortest
189,25,56,graphml/AttMpls.graphml,4,3,clustered,0.6;-0.3,2,2,2,0,16,2,0,2,2,0,0,shortest
188,25,56,graphml/AttMpls.graphml,2,1,clustered,0.6;-0.3,3,7,3,0,0,3,0,3,3,0,0,shortest
187,25,56,graphml/AttMpls.graphml,3,2,clustered,0.6;-0.3,3,3,3,0,0,6,3,3,3,0,0,shortest
186,25,56,graphml/AttMpls.graphml,5,4,clustered,0.6;-0.3,5,5,4,1,2,18,14,18,18,14,0,shortest
185,25,56,graphml/AttMpls.graphml,3,2,clustered,0.6;-0.3,13,13,4,9,10,-1,-5,13,13,9,4,shortest
184,25,56,graphml/AttMpls.graphml,2,1,clustered,0.6;-0.3,4,4,4,0,0,-1,-5,-1,-1,-5,0,shortest
183,25,56,graphml/AttMpls.graphml,3,2,clustered,0.6;-0.3,9,7,4,5,16,-1,-5,-1,-1,-5,0,shortest
182,25,56,graphml/AttMpls.graphml,2,1,clustered,0.6;-0.3,11,11,3,8,4,5,2,3,3,0,0,shortest
181,25,56,graphml/AttMpls.graphml,2,1,clustered,0.6;-0.3,-1,-1,5,-6,22,-1,-6,-1,-1,-6,0,shortest
180,25,56,graphml/AttMpls.graphml,2,1,clustered,0.6;-0.3,-1,-1,5,-6,4,-1,-6,-1,-1,-6,0,shortest
179,25,56,graphml/AttMpls.graphml,4,3,clustered,0.6;-0.3,-1,-1,4,-5,0,-1,-5,-1,-1,-5,0,shortest
177,25,56,graphml/AttMpls.graphml,3,2,clustered,0.6;-0.3,19,20,4,15,6,-1,-5,-1,-1,-5,0,shortest
176,25,56,graphml/AttMpls.graphml,3,2,clustered,0.6;-0.3,8,8,4,4,0,8,4,8,8,4,0,shortest
175,25,56,graphml/AttMpls.graphml,2,1,clustered,0.6;-0.3,3,3,3,0,0,-1,-4,-1,-1,-4,0,shortest
174,25,56,graphml/AttMpls.graphml,4,3,clustered,0.6;-0.3,3,3,3,0,4,3,0,3,3,0,2,shortest
173,25,56,graphml/AttMpls.graphml,4,3,clustered,0.6;-0.3,3,3,3,0,4,3,0,3,3,0,0,shortest
172,25,56,graphml/AttMpls.graphml,3,2,clustered,0.6;-0.3,7,5,3,4,8,5,2,5,19,2,6,shortest
171,25,56,graphml/AttMpls.graphml,3,2,clustered,0.6;-0.3,4,4,3,1,2,15,12,15,15,12,2,shortest
170,25,56,graphml/AttMpls.graphml,3,2,clustered,0.6;-0.3,2,2,2,0,14,2,0,2,2,0,14,shortest
169,25,56,graphml/AttMpls.graphml,3,2,clustered,0.6;-0.3,11,7,5,6,0,7,2,7,7,2,0,shortest
168,25,56,graphml/AttMpls.graphml,5,4,clustered,0.6;-0.3,2,2,2,0,0,2,0,2,2,0,0,shortest
166,25,56,graphml/AttMpls.graphml,2,1,clustered,0.6;-0.3,4,5,4,0,12,-1,-5,-1,-1,-5,0,shortest
165,25,56,graphml/AttMpls.graphml,4,3,clustered,0.6;-0.3,13,13,4,9,18,-1,-5,-1,-1,-5,0,shortest
164,25,56,graphml/AttMpls.graphml,3,2,clustered,0.6;-0.3,3,3,3,0,0,15,12,3,3,0,0,shortest
163,25,56,graphml/AttMpls.graphml,4,3,clustered,0.6;-0.3,3,3,3,0,2,3,0,3,3,0,0,shortest
162,25,56,graphml/AttMpls.graphml,3,2,clustered,0.6;-0.3,3,3,3,0,0,-1,-4,-1,-1,-4,0,shortest
160,25,56,graphml/AttMpls.graphml,3,2,clustered,0.6;-0.3,3,3,3,0,0,3,0,3,3,0,0,shortest
159,25,56,graphml/AttMpls.graphml,3,2,clustered,0.6;-0.3,2,2,2,0,4,2,0,2,2,0,0,shortest
158,25,56,graphml/AttMpls.graphml,2,1,clustered,0.6;-0.3,11,11,3,8,0,3,0,3,3,0,0,shortest
157,25,56,graphml/AttMpls.graphml,4,3,clustered,0.6;-0.3,2,2,2,0,0,2,0,2,2,0,0,shortest
156,25,56,graphml/AttMpls.graphml,3,2,clustered,0.6;-0.3,9,9,5,4,0,-1,-6,9,9,4,0,shortest
155,25,56,graphml/AttMpls.graphml,3,2,clustered,0.6;-0.3,11,9,3,8,0,9,6,9,9,6,0,shortest
154,25,56,graphml/AttMpls.graphml,2,1,clustered,0.6;-0.3,14,14,4,10,8,-1,-5,-1,-1,-5,0,shortest
153,25,56,graphml/AttMpls.graphml,4,3,clustered,0.6;-0.3,8,8,4,4,16,8,4,8,8,4,0,shortest
152,25,56,graphml/AttMpls.graphml,4,3,clustered,0.6;-0.3,15,25,3,12,8,15,12,15,15,12,2,shortest
150,25,56,graphml/AttMpls.graphml,2,1,clustered,0.6;-0.3,9,9,5,4,26,-1,-6,-1,-1,-6,0,shortest
149,25,56,graphml/AttMpls.graphml,2,1,clustered,0.6;-0.3,4,6,3,1,12,-1,-4,-1,-1,-4,0,shortest
147,25,56,graphml/AttMpls.graphml,3,2,clustered,0.6;-0.3,4,4,3,1,0,4,1,4,4,1,0,shortest
145,25,56,graphml/AttMpls.graphml,2,1,clustered,0.6;-0.3,3,3,3,0,0,3,0,3,3,0,0,shortest
143,25,56,graphml/AttMpls.graphml,2,1,clustered,0.6;-0.3,4,4,4,0,26,-1,-5,-1,-1,-5,0,shortest
142,25,56,graphml/AttMpls.graphml,3,2,clustered,0.6;-0.3,12,6,4,8,18,-1,-5,-1,-1,-5,0,shortest
141,25,56,graphml/AttMpls.graphml,4,3,clustered,0.6;-0.3,2,2,2,0,0,2,0,2,2,0,0,shortest
140,25,56,graphml/AttMpls.graphml,3,2,clustered,0.6;-0.3,6,10,3,3,6,6,3,6,6,3,2,shortest
139,25,56,graphml/AttMpls.graphml,3,2,clustered,0.6;-0.3,4,4,3,1,0,-1,-4,4,4,1,0,shortest
138,25,56,graphml/AttMpls.graphml,2,1,clustered,0.6;-0.3,6,6,3,3,0,6,3,6,6,3,0,shortest
137,25,56,graphml/AttMpls.graphml,3,2,clustered,0.6;-0.3,11,11,3,8,22,-1,-4,-1,-1,-4,6,shortest
134,25,56,graphml/AttMpls.graphml,4,3,clustered,0.6;-0.3,3,3,3,0,0,3,0,3,3,0,0,shortest
133,25,56,graphml/AttMpls.graphml,4,3,clustered,0.6;-0.3,4,4,2,2,0,4,2,4,4,2,0,shortest
132,25,56,graphml/AttMpls.graphml,4,3,clustered,0.6;-0.3,6,6,3,3,0,10,7,6,6,3,0,shortest
131,25,56,graphml/AttMpls.graphml,2,1,clustered,0.6;-0.3,6,6,4,2,0,-1,-5,-1,-1,-5,0,shortest
130,25,56,graphml/AttMpls.graphml,3,2,clustered,0.6;-0.3,14,12,6,8,0,-1,-7,-1,-1,-7,0,shortest
129,25,56,graphml/AttMpls.graphml,2,1,clustered,0.6;-0.3,4,4,4,0,6,8,4,8,8,4,2,shortest
128,25,56,graphml/AttMpls.graphml,2,1,clustered,0.6;-0.3,9,7,5,4,12,-1,-6,19,11,14,8,shortest
127,25,56,graphml/AttMpls.graphml,3,2,clustered,0.6;-0.3,-1,-1,4,-5,0,-1,-5,-1,-1,-5,0,shortest
126,25,56,graphml/AttMpls.graphml,4,3,clustered,0.6;-0.3,4,4,4,0,0,4,0,4,4,0,0,shortest
124,25,56,graphml/AttMpls.graphml,5,4,clustered,0.6;-0.3,5,5,3,2,14,5,2,5,5,2,6,shortest
123,25,56,graphml/AttMpls.graphml,4,3,clustered,0.6;-0.3,-1,-1,3,-4,0,-1,-4,-1,-1,-4,0,shortest
122,25,56,graphml/AttMpls.graphml,2,1,clustered,0.6;-0.3,-1,-1,6,-7,8,-1,-7,-1,-1,-7,0,shortest
121,25,56,graphml/AttMpls.graphml,5,4,clustered,0.6;-0.3,9,13,3,6,0,-1,-4,-1,-1,-4,0,shortest
120,25,56,graphml/AttMpls.graphml,2,1,clustered,0.6;-0.3,5,5,5,0,0,-1,-6,-1,-1,-6,0,shortest
119,25,56,graphml/AttMpls.graphml,2,1,clustered,0.6;-0.3,22,18,4,18,12,-1,-5,13,9,9,6,shortest
118,25,56,graphml/AttMpls.graphml,3,2,clustered,0.6;-0.3,3,3,3,0,0,3,0,3,3,0,0,shortest
117,25,56,graphml/AttMpls.graphml,2,1,clustered,0.6;-0.3,3,3,2,1,6,3,1,3,3,1,0,shortest
116,25,56,graphml/AttMpls.graphml,2,1,clustered,0.6;-0.3,14,30,3,11,12,8,5,8,14,5,6,shortest
115,25,56,graphml/AttMpls.graphml,2,1,clustered,0.6;-0.3,-1,-1,6,-7,6,-1,-7,-1,-1,-7,0,shortest
114,25,56,graphml/AttMpls.graphml,3,2,clustered,0.6;-0.3,5,5,3,2,0,3,0,5,5,2,0,shortest
113,25,56,graphml/AttMpls.graphml,5,4,clustered,0.6;-0.3,6,6,3,3,0,16,13,6,6,3,0,shortest
112,25,56,graphml/AttMpls.graphml,5,4,clustered,0.6;-0.3,2,2,2,0,14,2,0,6,6,4,6,shortest
111,25,56,graphml/AttMpls.graphml,2,1,clustered,0.6;-0.3,8,8,5,3,0,-1,-6,-1,-1,-6,0,shortest
110,25,56,graphml/AttMpls.graphml,2,1,clustered,0.6;-0.3,4,4,4,0,6,8,4,8,8,4,0,shortest
109,25,56,graphml/AttMpls.graphml,2,1,clustered,0.6;-0.3,3,3,3,0,0,3,0,3,3,0,0,shortest
108,25,56,graphml/AttMpls.graphml,2,1,clustered,0.6;-0.3,5,6,5,0,10,-1,-6,9,5,4,4,shortest
107,25,56,graphml/AttMpls.graphml,2,1,clustered,0.6;-0.3,22,22,5,17,12,-1,-6,-1,-1,-6,0,shortest
106,25,56,graphml/AttMpls.graphml,3,2,clustered,0.6;-0.3,3,3,3,0,0,9,6,3,3,0,0,shortest
105,25,56,graphml/AttMpls.graphml,2,1,clustered,0.6;-0.3,-1,-1,4,-5,12,-1,-5,-1,-1,-5,0,shortest
103,25,56,graphml/AttMpls.graphml,2,1,clustered,0.6;-0.3,22,18,5,17,8,-1,-6,16,16,11,4,shortest
102,25,56,graphml/AttMpls.graphml,2,1,clustered,0.6;-0.3,3,3,3,0,0,3,0,3,3,0,0,shortest
100,25,56,graphml/AttMpls.graphml,2,1,clustered,0.6;-0.3,3,3,3,0,0,3,0,3,3,0,0,shortest
99,25,56,graphml/AttMpls.graphml,5,4,clustered,0.6;-0.3,33,33,5,28,0,-1,-6,-1,-1,-6,0,shortest
98,25,56,graphml/AttMpls.graphml,3,2,clustered,0.6;-0.3,5,25,3,2,4,5,2,5,5,2,0,shortest
97,25,56,graphml/AttMpls.graphml,3,2,clustered,0.6;-0.3,2,2,2,0,2,-1,-3,2,2,0,0,shortest
96,25,56,graphml/AttMpls.graphml,3,2,clustered,0.6;-0.3,-1,-1,3,-4,14,-1,-4,-1,-1,-4,0,shortest
95,25,56,graphml/AttMpls.graphml,3,2,clustered,0.6;-0.3,4,4,2,2,0,4,2,4,4,2,0,shortest
93,25,56,graphml/AttMpls.graphml,5,4,clustered,0.6;-0.3,3,3,2,1,0,-1,-3,3,3,1,0,shortest
92,25,56,graphml/AttMpls.graphml,2,1,clustered,0.6;-0.3,-1,-1,3,-4,12,-1,-4,-1,-1,-4,0,shortest
91,25,56,graphml/AttMpls.graphml,2,1,clustered,0.6;-0.3,5,11,3,2,0,3,0,5,5,2,0,shortest
90,25,56,graphml/AttMpls.graphml,3,2,clustered,0.6;-0.3,4,5,3,1,4,4,1,4,4,1,0,shortest
89,25,56,graphml/AttMpls.graphml,2,1,clustered,0.6;-0.3,4,4,4,0,12,4,0,4,4,0,0,shortest
88,25,56,graphml/AttMpls.graphml,4,3,clustered,0.6;-0.3,4,4,3,1,4,10,7,10,10,7,0,shortest
87,25,56,graphml/AttMpls.graphml,2,1,clustered,0.6;-0.3,9,5,4,5,8,-1,-5,18,18,14,4,shortest
86,25,56,graphml/AttMpls.graphml,3,2,clustered,0.6;-0.3,8,12,4,4,0,4,0,8,8,4,0,shortest
85,25,56,graphml/AttMpls.graphml,6,5,clustered,0.6;-0.3,5,5,3,2,0,5,2,9,9,6,0,shortest
84,25,56,graphml/AttMpls.graphml,4,3,clustered,0.6;-0.3,6,6,3,3,18,6,3,6,6,3,0,shortest
83,25,56,graphml/AttMpls.graphml,2,1,clustered,0.6;-0.3,3,3,3,0,0,3,0,3,3,0,0,shortest
82,25,56,graphml/AttMpls.graphml,3,2,clustered,0.6;-0.3,22,18,4,18,0,16,12,16,16,12,0,shortest
81,25,56,graphml/AttMpls.graphml,2,1,clustered,0.6;-0.3,10,10,3,7,20,-1,-4,-1,-1,-4,0,shortest
80,25,56,graphml/AttMpls.graphml,3,2,clustered,0.6;-0.3,2,2,2,0,0,4,2,4,4,2,0,shortest
79,25,56,graphml/AttMpls.graphml,2,1,clustered,0.6;-0.3,-1,-1,4,-5,0,-1,-5,-1,-1,-5,0,shortest
78,25,56,graphml/AttMpls.graphml,2,1,clustered,0.6;-0.3,3,3,2,1,6,3,1,3,3,1,0,shortest
76,25,56,graphml/AttMpls.graphml,5,4,clustered,0.6;-0.3,2,2,2,0,2,2,0,2,2,0,0,shortest
75,25,56,graphml/AttMpls.graphml,3,2,clustered,0.6;-0.3,-1,-1,4,-5,0,-1,-5,-1,-1,-5,0,shortest
74,25,56,graphml/AttMpls.graphml,2,1,clustered,0.6;-0.3,2,2,2,0,0,2,0,2,2,0,0,shortest
73,25,56,graphml/AttMpls.graphml,3,2,clustered,0.6;-0.3,21,23,4,17,4,-1,-5,-1,-1,-5,0,shortest
72,25,56,graphml/AttMpls.graphml,5,4,clustered,0.6;-0.3,3,3,3,0,0,3,0,3,3,0,0,shortest
71,25,56,graphml/AttMpls.graphml,4,3,clustered,0.6;-0.3,8,8,4,4,0,-1,-5,-1,-1,-5,0,shortest
70,25,56,graphml/AttMpls.graphml,4,3,clustered,0.6;-0.3,4,4,4,0,0,15,11,4,4,0,0,shortest
68,25,56,graphml/AttMpls.graphml,5,4,clustered,0.6;-0.3,2,2,2,0,14,2,0,2,2,0,6,shortest
67,25,56,graphml/AttMpls.graphml,3,2,clustered,0.6;-0.3,3,3,3,0,16,3,0,3,3,0,8,shortest
66,25,56,graphml/AttMpls.graphml,4,3,clustered,0.6;-0.3,14,12,3,11,4,12,9,12,12,9,0,shortest
65,25,56,graphml/AttMpls.graphml,4,3,clustered,0.6;-0.3,8,6,3,5,4,10,7,12,12,9,0,shortest
63,25,56,graphml/AttMpls.graphml,4,3,clustered,0.6;-0.3,3,7,3,0,4,3,0,3,3,0,0,shortest
61,25,56,graphml/AttMpls.graphml,2,1,clustered,0.6;-0.3,5,5,5,0,0,-1,-6,-1,-1,-6,0,shortest
60,25,56,graphml/AttMpls.graphml,2,1,clustered,0.6;-0.3,5,5,4,1,22,-1,-5,-1,-1,-5,0,shortest
59,25,56,graphml/AttMpls.graphml,4,3,clustered,0.6;-0.3,-1,-1,3,-4,0,-1,-4,-1,-1,-4,0,shortest
58,25,56,graphml/AttMpls.graphml,2,1,clustered,0.6;-0.3,3,5,3,0,12,3,0,3,3,0,6,shortest
57,25,56,graphml/AttMpls.graphml,3,2,clustered,0.6;-0.3,22,22,4,18,0,-1,-5,-1,-1,-5,0,shortest
55,25,56,graphml/AttMpls.graphml,3,2,clustered,0.6;-0.3,5,3,3,2,24,3,0,3,3,0,12,shortest
54,25,56,graphml/AttMpls.graphml,4,3,clustered,0.6;-0.3,7,7,3,4,2,7,4,3,3,0,0,shortest
52,25,56,graphml/AttMpls.graphml,3,2,clustered,0.6;-0.3,5,5,5,0,0,15,10,5,5,0,0,shortest
51,25,56,graphml/AttMpls.graphml,4,3,clustered,0.6;-0.3,6,6,3,3,4,6,3,6,6,3,0,shortest
50,25,56,graphml/AttMpls.graphml,3,2,clustered,0.6;-0.3,6,6,3,3,0,8,5,8,8,5,0,shortest
49,25,56,graphml/AttMpls.graphml,2,1,clustered,0.6;-0.3,8,8,2,6,0,2,0,2,2,0,0,shortest
48,25,56,graphml/AttMpls.graphml,5,4,clustered,0.6;-0.3,24,24,2,22,8,4,2,4,4,2,0,shortest
47,25,56,graphml/AttMpls.graphml,2,1,clustered,0.6;-0.3,7,5,5,2,0,-1,-6,-1,-1,-6,0,shortest
46,25,56,graphml/AttMpls.graphml,2,1,clustered,0.6;-0.3,2,2,2,0,0,4,2,4,4,2,0,shortest
44,25,56,graphml/AttMpls.graphml,3,2,clustered,0.6;-0.3,6,14,4,2,0,4,0,6,6,2,0,shortest
43,25,56,graphml/AttMpls.graphml,2,1,clustered,0.6;-0.3,-1,-1,6,-7,0,-1,-7,-1,-1,-7,0,shortest
42,25,56,graphml/AttMpls.graphml,5,4,clustered,0.6;-0.3,38,38,6,32,2,32,26,32,32,26,0,shortest
40,25,56,graphml/AttMpls.graphml,2,1,clustered,0.6;-0.3,-1,-1,6,-7,0,-1,-7,-1,-1,-7,0,shortest
39,25,56,graphml/AttMpls.graphml,5,4,clustered,0.6;-0.3,4,4,2,2,0,4,2,4,4,2,0,shortest
38,25,56,graphml/AttMpls.graphml,2,1,clustered,0.6;-0.3,18,18,4,14,22,-1,-5,8,8,4,4,shortest
37,25,56,graphml/AttMpls.graphml,3,2,clustered,0.6;-0.3,9,7,4,5,14,-1,-5,-1,-1,-5,0,shortest
36,25,56,graphml/AttMpls.graphml,3,2,clustered,0.6;-0.3,8,8,4,4,0,8,4,8,8,4,0,shortest
35,25,56,graphml/AttMpls.graphml,2,1,clustered,0.6;-0.3,14,14,5,9,0,8,3,8,8,3,0,shortest
34,25,56,graphml/AttMpls.graphml,4,3,clustered,0.6;-0.3,-1,-1,4,-5,12,-1,-5,-1,-1,-5,0,shortest
33,25,56,graphml/AttMpls.graphml,3,2,clustered,0.6;-0.3,2,2,2,0,10,4,2,2,2,0,6,shortest
32,25,56,graphml/AttMpls.graphml,2,1,clustered,0.6;-0.3,3,3,3,0,0,3,0,3,3,0,0,shortest
31,25,56,graphml/AttMpls.graphml,3,2,clustered,0.6;-0.3,5,9,3,2,0,5,2,5,5,2,0,shortest
29,25,56,graphml/AttMpls.graphml,5,4,clustered,0.6;-0.3,2,2,2,0,0,2,0,2,2,0,0,shortest
28,25,56,graphml/AttMpls.graphml,3,2,clustered,0.6;-0.3,8,8,4,4,0,8,4,8,8,4,0,shortest
27,25,56,graphml/AttMpls.graphml,2,1,clustered,0.6;-0.3,5,5,5,0,14,-1,-6,-1,-1,-6,0,shortest
25,25,56,graphml/AttMpls.graphml,3,2,clustered,0.6;-0.3,23,9,4,19,8,9,5,9,9,5,0,shortest
24,25,56,graphml/AttMpls.graphml,2,1,clustered,0.6;-0.3,5,5,3,2,0,3,0,5,5,2,0,shortest
23,25,56,graphml/AttMpls.graphml,2,1,clustered,0.6;-0.3,3,9,3,0,12,3,0,3,3,0,0,shortest
22,25,56,graphml/AttMpls.graphml,5,4,clustered,0.6;-0.3,3,11,3,0,2,-1,-4,7,7,4,0,shortest
21,25,56,graphml/AttMpls.graphml,2,1,clustered,0.6;-0.3,-1,-1,5,-6,0,-1,-6,-1,-1,-6,0,shortest
20,25,56,graphml/AttMpls.graphml,4,3,clustered,0.6;-0.3,10,10,4,6,2,4,0,10,10,6,0,shortest
18,25,56,graphml/AttMpls.graphml,2,1,clustered,0.6;-0.3,4,4,3,1,2,8,5,8,8,5,0,shortest
17,25,56,graphml/AttMpls.graphml,5,4,clustered,0.6;-0.3,12,12,3,9,0,10,7,12,12,9,0,shortest
16,25,56,graphml/AttMpls.graphml,3,2,clustered,0.6;-0.3,3,3,3,0,0,13,10,3,3,0,0,shortest
15,25,56,graphml/AttMpls.graphml,2,1,clustered,0.6;-0.3,-1,-1,5,-6,12,-1,-6,-1,-1,-6,0,shortest
14,25,56,graphml/AttMpls.graphml,3,2,clustered,0.6;-0.3,13,11,3,10,14,9,6,7,7,4,0,shortest
13,25,56,graphml/AttMpls.graphml,4,3,clustered,0.6;-0.3,8,8,4,4,4,8,4,8,8,4,0,shortest
12,25,56,graphml/AttMpls.graphml,3,2,clustered,0.6;-0.3,12,6,4,8,10,8,4,8,8,4,0,shortest
11,25,56,graphml/AttMpls.graphml,4,3,clustered,0.6;-0.3,-1,-1,3,-4,0,-1,-4,-1,-1,-4,0,shortest
10,25,56,graphml/AttMpls.graphml,4,3,clustered,0.6;-0.3,27,27,5,22,0,17,12,23,23,18,0,shortest
9,25,56,graphml/AttMpls.graphml,2,1,clustered,0.6;-0.3,3,3,3,0,20,-1,-4,3,3,0,0,shortest
8,25,56,graphml/AttMpls.graphml,4,3,clustered,0.6;-0.3,11,11,4,7,0,11,7,11,11,7,0,shortest
7,25,56,graphml/AttMpls.graphml,5,4,clustered,0.6;-0.3,2,2,2,0,2,2,0,2,2,0,0,shortest
6,25,56,graphml/AttMpls.graphml,2,1,clustered,0.6;-0.3,-1,-1,6,-7,0,-1,-7,-1,-1,-7,0,shortest
4,25,56,graphml/AttMpls.graphml,5,4,clustered,0.6;-0.3,2,2,2,0,0,5,3,2,2,0,0,shortest
3,25,56,graphml/AttMpls.graphml,3,2,clustered,0.6;-0.3,8,8,3,5,0,4,1,8,8,5,0,shortest
2,25,56,graphml/AttMpls.graphml,4,3,clustered,0.6;-0.3,9,13,4,5,0,9,5,9,9,5,0,shortest
1,25,56,graphml/AttMpls.graphml,3,2,clustered,0.6;-0.3,2,2,2,0,10,2,0,2,2,0,0,shortest
