rep,nrNodes,nrEdges,edgeProb,nrPaths,nrFails,failureModel,failurePercent,hopsRanked,hopsUnranked,spLength,stretch_mult,nodeAdditions,hopsPath,stretch_path,hopsRankedOne,hopsUnrankedOne,stretch_one,overallNodeAdditionsOne,treeChoice
999,149,193,graphml/GtsCe.graphml,1,0,clustered,0.6;-0.3,13,67,13,0,6,13,0,13,67,0,6,edgeCount
997,149,193,graphml/GtsCe.graphml,2,1,clustered,0.6;-0.3,59,59,15,44,0,59,44,59,59,44,0,edgeCount
996,149,193,graphml/GtsCe.graphml,2,1,clustered,0.6;-0.3,14,14,14,0,0,14,0,14,14,0,0,edgeCount
995,149,193,graphml/GtsCe.graphml,1,0,clustered,0.6;-0.3,3,25,3,0,4,3,0,3,25,0,4,edgeCount
994,149,193,graphml/GtsCe.graphml,2,1,clustered,0.6;-0.3,40,40,15,25,0,40,25,40,40,25,0,edgeCount
993,149,193,graphml/GtsCe.graphml,3,2,clustered,0.6;-0.3,28,28,9,19,2,28,19,28,28,19,2,edgeCount
992,149,193,graphml/GtsCe.graphml,2,1,clustered,0.6;-0.3,-1,-1,7,-8,4,-1,-8,11,11,4,4,edgeCount
991,149,193,graphml/GtsCe.graphml,3,2,clustered,0.6;-0.3,42,42,10,32,2,16,6,42,42,32,2,edgeCount
990,149,193,graphml/GtsCe.graphml,2,1,clustered,0.6;-0.3,4,24,4,0,0,4,0,4,4,0,0,edgeCount
988,149,193,graphml/GtsCe.graphml,2,1,clustered,0.6;-0.3,24,24,10,14,2,24,14,12,52,2,2,edgeCount
987,149,193,graphml/GtsCe.graphml,3,2,clustered,0.6;-0.3,26,28,6,20,4,8,2,24,28,18,4,edgeCount
986,149,193,graphml/GtsCe.graphml,2,1,clustered,0.6;-0.3,16,16,16,0,0,16,0,16,16,0,0,edgeCount
985,149,193,graphml/GtsCe.graphml,2,1,clustered,0.6;-0.3,55,33,14,41,0,33,19,33,33,19,0,edgeCount
984,149,193,graphml/GtsCe.graphml,2,1,clustered,0.6;-0.3,-1,-1,9,-10,0,-1,-10,-1,-1,-10,0,edgeCount
983,149,193,graphml/GtsCe.graphml,1,0,clustered,0.6;-0.3,6,6,6,0,0,6,0,6,6,0,0,edgeCount
982,149,193,graphml/GtsCe.graphml,2,1,clustered,0.6;-0.3,-1,-1,18,-19,0,-1,-19,-1,-1,-19,0,edgeCount
981,149,193,graphml/GtsCe.graphml,1,0,clustered,0.6;-0.3,18,18,18,0,2,18,0,18,18,0,2,edgeCount
980,149,193,graphml/GtsCe.graphml,1,0,clustered,0.6;-0.3,7,7,7,0,0,7,0,7,7,0,0,edgeCount
978,149,193,graphml/GtsCe.graphml,2,1,clustered,0.6;-0.3,10,10,9,1,0,10,1,10,10,1,0,edgeCount
976,149,193,graphml/GtsCe.graphml,2,1,clustered,0.6;-0.3,16,16,15,1,0,16,1,16,16,1,0,edgeCount
975,149,193,graphml/GtsCe.graphml,2,1,clustered,0.6;-0.3,8,8,5,3,0,22,17,8,8,3,0,edgeCount
973,149,193,graphml/GtsCe.graphml,1,0,clustered,0.6;-0.3,3,19,3,0,4,3,0,3,19,0,4,edgeCount
972,149,193,graphml/GtsCe.graphml,2,1,clustered,0.6;-0.3,15,15,7,8,0,15,8,15,15,8,0,edgeCount
970,149,193,graphml/GtsCe.graphml,2,1,clustered,0.6;-0.3,57,57,19,38,2,57,38,57,57,38,2,edgeCount
969,149,193,graphml/GtsCe.graphml,3,2,clustered,0.6;-0.3,114,114,13,101,6,92,79,106,106,93,6,edgeCount
968,149,193,graphml/GtsCe.graphml,2,1,clustered,0.6;-0.3,12,12,5,7,0,10,5,10,10,5,0,edgeCount
966,149,193,graphml/GtsCe.graphml,2,1,clustered,0.6;-0.3,37,37,14,23,0,37,23,37,37,23,0,edgeCount
965,149,193,graphml/GtsCe.graphml,2,1,clustered,0.6;-0.3,16,16,15,1,0,16,1,16,16,1,0,edgeCount
964,149,193,graphml/GtsCe.graphml,1,0,clustered,0.6;-0.3,13,13,13,0,0,13,0,13,13,0,0,edgeCount
961,149,193,graphml/GtsCe.graphml,2,1,clustered,0.6;-0.3,6,6,5,1,2,6,1,14,6,9,2,edgeCount
960,149,193,graphml/GtsCe.graphml,1,0,clustered,0.6;-0.3,7,7,7,0,0,7,0,7,7,0,0,edgeCount
959,149,193,graphml/GtsCe.graphml,2,1,clustered,0.6;-0.3,25,25,13,12,0,-1,-14,-1,-1,-14,0,edgeCount
958,149,193,graphml/GtsCe.graphml,2,1,clustered,0.6;-0.3,37,37,11,26,0,-1,-12,-1,-1,-12,0,edgeCount
957,149,193,graphml/GtsCe.graphml,3,2,clustered,0.6;-0.3,7,7,7,0,0,-1,-8,7,7,0,0,edgeCount
955,149,193,graphml/GtsCe.graphml,2,1,clustered,0.6;-0.3,19,25,7,12,0,19,12,19,19,12,0,edgeCount
954,149,193,graphml/GtsCe.graphml,3,2,clustered,0.6;-0.3,12,14,4,8,0,12,8,12,14,8,0,edgeCount
953,149,193,graphml/GtsCe.graphml,2,1,clustered,0.6;-0.3,6,6,6,0,2,6,0,30,6,24,2,edgeCount
952,149,193,graphml/GtsCe.graphml,2,1,clustered,0.6;-0.3,23,23,9,14,6,23,14,13,53,4,6,edgeCount
950,149,193,graphml/GtsCe.graphml,3,2,clustered,0.6;-0.3,14,14,10,4,0,14,4,14,14,4,0,edgeCount
949,149,193,graphml/GtsCe.graphml,2,1,clustered,0.6;-0.3,-1,-1,5,-6,0,-1,-6,-1,-1,-6,0,edgeCount
948,149,193,graphml/GtsCe.graphml,2,1,clustered,0.6;-0.3,37,75,19,18,0,37,18,37,37,18,0,edgeCount
947,149,193,graphml/GtsCe.graphml,1,0,clustered,0.6;-0.3,10,10,10,0,0,10,0,10,10,0,0,edgeCount
946,149,193,graphml/GtsCe.graphml,3,2,clustered,0.6;-0.3,-1,-1,11,-12,4,-1,-12,-1,-1,-12,4,edgeCount
945,149,193,graphml/GtsCe.graphml,2,1,clustered,0.6;-0.3,24,24,13,11,0,24,11,24,24,11,0,edgeCount
943,149,193,graphml/GtsCe.graphml,2,1,clustered,0.6;-0.3,-1,-1,13,-14,0,-1,-14,-1,-1,-14,0,edgeCount
942,149,193,graphml/GtsCe.graphml,1,0,clustered,0.6;-0.3,11,11,11,0,0,11,0,11,11,0,0,edgeCount
941,149,193,graphml/GtsCe.graphml,1,0,clustered,0.6;-0.3,16,16,16,0,0,16,0,16,16,0,0,edgeCount
939,149,193,graphml/GtsCe.graphml,2,1,clustered,0.6;-0.3,6,6,6,0,0,6,0,6,6,0,0,edgeCount
937,149,193,graphml/GtsCe.graphml,2,1,clustered,0.6;-0.3,47,47,13,34,0,47,34,47,47,34,0,edgeCount
935,149,193,graphml/GtsCe.graphml,2,1,clustered,0.6;-0.3,59,39,17,42,0,-1,-18,-1,-1,-18,0,edgeCount
934,149,193,graphml/GtsCe.graphml,3,2,clustered,0.6;-0.3,48,48,11,37,0,48,37,48,48,37,0,edgeCount
933,149,193,graphml/GtsCe.graphml,2,1,clustered,0.6;-0.3,8,8,7,1,2,8,1,18,8,11,2,edgeCount
931,149,193,graphml/GtsCe.graphml,1,0,clustered,0.6;-0.3,12,12,12,0,0,12,0,12,12,0,0,edgeCount
929,149,193,graphml/GtsCe.graphml,2,1,clustered,0.6;-0.3,13,13,13,0,0,13,0,13,13,0,0,edgeCount
928,149,193,graphml/GtsCe.graphml,2,1,clustered,0.6;-0.3,27,36,9,18,4,27,18,13,14,4,4,edgeCount
927,149,193,graphml/GtsCe.graphml,2,1,clustered,0.6;-0.3,5,5,5,0,0,5,0,5,5,0,0,edgeCount
926,149,193,graphml/GtsCe.graphml,2,1,clustered,0.6;-0.3,59,39,14,45,0,39,25,39,39,25,0,edgeCount
924,149,193,graphml/GtsCe.graphml,2,1,clustered,0.6;-0.3,22,22,13,9,0,22,9,22,22,9,0,edgeCount
923,149,193,graphml/GtsCe.graphml,2,1,clustered,0.6;-0.3,31,39,11,20,0,-1,-12,-1,-1,-12,0,edgeCount
922,149,193,graphml/GtsCe.graphml,2,1,clustered,0.6;-0.3,12,12,12,0,4,12,0,12,18,0,4,edgeCount
921,149,193,graphml/GtsCe.graphml,3,2,clustered,0.6;-0.3,35,35,8,27,0,15,7,35,35,27,0,edgeCount
919,149,193,graphml/GtsCe.graphml,2,1,clustered,0.6;-0.3,9,27,3,6,4,3,0,9,27,6,4,edgeCount
917,149,193,graphml/GtsCe.graphml,1,0,clustered,0.6;-0.3,15,49,15,0,2,15,0,15,49,0,2,edgeCount
916,149,193,graphml/GtsCe.graphml,3,2,clustered,0.6;-0.3,64,64,12,52,0,56,44,56,56,44,0,edgeCount
915,149,193,graphml/GtsCe.graphml,1,0,clustered,0.6;-0.3,-1,-1,10,-11,0,-1,-11,-1,-1,-11,0,edgeCount
913,149,193,graphml/GtsCe.graphml,1,0,clustered,0.6;-0.3,7,7,7,0,0,7,0,7,7,0,0,edgeCount
911,149,193,graphml/GtsCe.graphml,1,0,clustered,0.6;-0.3,12,12,12,0,0,12,0,12,12,0,0,edgeCount
910,149,193,graphml/GtsCe.graphml,2,1,clustered,0.6;-0.3,3,3,3,0,0,3,0,3,3,0,0,edgeCount
909,149,193,graphml/GtsCe.graphml,2,1,clustered,0.6;-0.3,46,46,13,33,0,26,13,26,26,13,0,edgeCount
906,149,193,graphml/GtsCe.graphml,2,1,clustered,0.6;-0.3,29,29,13,16,0,29,16,29,29,16,0,edgeCount
904,149,193,graphml/GtsCe.graphml,2,1,clustered,0.6;-0.3,17,17,16,1,4,17,1,17,17,1,4,edgeCount
903,149,193,graphml/GtsCe.graphml,2,1,clustered,0.6;-0.3,33,33,11,22,0,33,22,33,33,22,0,edgeCount
901,149,193,graphml/GtsCe.graphml,2,1,clustered,0.6;-0.3,25,27,10,15,2,25,15,25,25,15,2,edgeCount
900,149,193,graphml/GtsCe.graphml,1,0,clustered,0.6;-0.3,12,12,12,0,0,12,0,12,12,0,0,edgeCount
899,149,193,graphml/GtsCe.graphml,2,1,clustered,0.6;-0.3,23,23,10,13,0,23,13,23,23,13,0,edgeCount
895,149,193,graphml/GtsCe.graphml,3,2,clustered,0.6;-0.3,49,61,10,39,0,-1,-11,-1,-1,-11,0,edgeCount
894,149,193,graphml/GtsCe.graphml,2,1,clustered,0.6;-0.3,37,37,13,24,0,37,24,37,37,24,0,edgeCount
892,149,193,graphml/GtsCe.graphml,2,1,clustered,0.6;-0.3,5,5,5,0,2,5,0,8,27,3,2,edgeCount
891,149,193,graphml/GtsCe.graphml,2,1,clustered,0.6;-0.3,17,17,6,11,4,15,9,7,49,1,4,edgeCount
889,149,193,graphml/GtsCe.graphml,2,1,clustered,0.6;-0.3,37,37,14,23,2,37,23,37,37,23,2,edgeCount
887,149,193,graphml/GtsCe.graphml,1,0,clustered,0.6;-0.3,10,10,10,0,0,10,0,10,10,0,0,edgeCount
886,149,193,graphml/GtsCe.graphml,1,0,clustered,0.6;-0.3,5,5,5,0,0,5,0,5,5,0,0,edgeCount
884,149,193,graphml/GtsCe.graphml,2,1,clustered,0.6;-0.3,7,7,7,0,0,7,0,7,7,0,0,edgeCount
883,149,193,graphml/GtsCe.graphml,2,1,clustered,0.6;-0.3,-1,-1,15,-16,0,-1,-16,-1,-1,-16,0,edgeCount
881,149,193,graphml/GtsCe.graphml,2,1,clustered,0.6;-0.3,17,17,5,12,2,17,12,17,17,12,2,edgeCount
880,149,193,graphml/GtsCe.graphml,1,0,clustered,0.6;-0.3,-1,-1,17,-18,0,-1,-18,-1,-1,-18,0,edgeCount
879,149,193,graphml/GtsCe.graphml,2,1,clustered,0.6;-0.3,10,10,6,4,0,10,4,10,10,4,0,edgeCount
877,149,193,graphml/GtsCe.graphml,3,2,clustered,0.6;-0.3,7,7,5,2,2,7,2,7,7,2,2,edgeCount
875,149,193,graphml/GtsCe.graphml,2,1,clustered,0.6;-0.3,-1,-1,10,-11,0,-1,-11,-1,-1,-11,0,edgeCount
874,149,193,graphml/GtsCe.graphml,2,1,clustered,0.6;-0.3,19,19,14,5,0,19,5,19,19,5,0,edgeCount
873,149,193,graphml/GtsCe.graphml,2,1,clustered,0.6;-0.3,38,38,13,25,2,38,25,52,52,39,2,edgeCount
872,149,193,graphml/GtsCe.graphml,2,1,clustered,0.6;-0.3,24,24,10,14,2,24,14,10,28,0,2,edgeCount
871,149,193,graphml/GtsCe.graphml,3,2,clustered,0.6;-0.3,3,3,3,0,0,3,0,3,3,0,0,edgeCount
870,149,193,graphml/GtsCe.graphml,2,1,clustered,0.6;-0.3,11,11,11,0,0,11,0,11,11,0,0,edgeCount
868,149,193,graphml/GtsCe.graphml,2,1,clustered,0.6;-0.3,13,13,13,0,0,13,0,13,13,0,0,edgeCount
867,149,193,graphml/GtsCe.graphml,2,1,clustered,0.6;-0.3,82,90,18,64,6,-1,-19,98,46,80,6,edgeCount
866,149,193,graphml/GtsCe.graphml,3,2,clustered,0.6;-0.3,14,14,12,2,0,79,67,79,79,67,0,edgeCount
865,149,193,graphml/GtsCe.graphml,2,1,clustered,0.6;-0.3,9,9,8,1,2,9,1,9,9,1,2,edgeCount
864,149,193,graphml/GtsCe.graphml,2,1,clustered,0.6;-0.3,19,19,6,13,0,19,13,19,19,13,0,edgeCount
862,149,193,graphml/GtsCe.graphml,2,1,clustered,0.6;-0.3,17,17,17,0,0,17,0,17,17,0,0,edgeCount
860,149,193,graphml/GtsCe.graphml,2,1,clustered,0.6;-0.3,12,12,12,0,2,12,0,12,12,0,2,edgeCount
859,149,193,graphml/GtsCe.graphml,1,0,clustered,0.6;-0.3,33,15,13,20,8,-1,-14,33,15,20,8,edgeCount
858,149,193,graphml/GtsCe.graphml,1,0,clustered,0.6;-0.3,13,13,13,0,0,13,0,13,13,0,0,edgeCount
856,149,193,graphml/GtsCe.graphml,2,1,clustered,0.6;-0.3,53,53,19,34,2,53,34,53,53,34,2,edgeCount
855,149,193,graphml/GtsCe.graphml,2,1,clustered,0.6;-0.3,32,32,10,22,2,32,22,16,54,6,2,edgeCount
853,149,193,graphml/GtsCe.graphml,2,1,clustered,0.6;-0.3,-1,-1,9,-10,4,-1,-10,-1,-1,-10,4,edgeCount
852,149,193,graphml/GtsCe.graphml,2,1,clustered,0.6;-0.3,28,28,11,17,0,28,17,28,28,17,0,edgeCount
850,149,193,graphml/GtsCe.graphml,2,1,clustered,0.6;-0.3,16,16,14,2,0,16,2,16,16,2,0,edgeCount
849,149,193,graphml/GtsCe.graphml,2,1,clustered,0.6;-0.3,9,9,9,0,0,9,0,9,9,0,0,edgeCount
848,149,193,graphml/GtsCe.graphml,2,1,clustered,0.6;-0.3,59,59,18,41,4,59,41,59,59,41,4,edgeCount
847,149,193,graphml/GtsCe.graphml,2,1,clustered,0.6;-0.3,15,23,7,8,6,15,8,15,23,8,6,edgeCount
845,149,193,graphml/GtsCe.graphml,1,0,clustered,0.6;-0.3,18,66,18,0,2,18,0,18,66,0,2,edgeCount
844,149,193,graphml/GtsCe.graphml,2,1,clustered,0.6;-0.3,45,33,6,39,8,-1,-7,6,6,0,8,edgeCount
842,149,193,graphml/GtsCe.graphml,2,1,clustered,0.6;-0.3,14,14,8,6,0,14,6,14,14,6,0,edgeCount
840,149,193,graphml/GtsCe.graphml,2,1,clustered,0.6;-0.3,11,11,11,0,6,-1,-12,-1,-1,-12,6,edgeCount
839,149,193,graphml/GtsCe.graphml,2,1,clustered,0.6;-0.3,8,8,6,2,0,-1,-7,8,8,2,0,edgeCount
837,149,193,graphml/GtsCe.graphml,2,1,clustered,0.6;-0.3,16,12,11,5,6,34,23,34,34,23,6,edgeCount
836,149,193,graphml/GtsCe.graphml,1,0,clustered,0.6;-0.3,-1,-1,10,-11,2,-1,-11,-1,-1,-11,2,edgeCount
834,149,193,graphml/GtsCe.graphml,2,1,clustered,0.6;-0.3,12,12,11,1,0,12,1,12,12,1,0,edgeCount
833,149,193,graphml/GtsCe.graphml,3,2,clustered,0.6;-0.3,37,37,9,28,4,-1,-10,37,37,28,4,edgeCount
832,149,193,graphml/GtsCe.graphml,1,0,clustered,0.6;-0.3,14,14,14,0,0,14,0,14,14,0,0,edgeCount
830,149,193,graphml/GtsCe.graphml,2,1,clustered,0.6;-0.3,75,55,17,58,0,-1,-18,-1,-1,-18,0,edgeCount
829,149,193,graphml/GtsCe.graphml,2,1,clustered,0.6;-0.3,15,15,7,8,2,15,8,7,25,0,2,edgeCount
826,149,193,graphml/GtsCe.graphml,1,0,clustered,0.6;-0.3,12,12,12,0,0,12,0,12,12,0,0,edgeCount
825,149,193,graphml/GtsCe.graphml,2,1,clustered,0.6;-0.3,12,12,12,0,0,12,0,12,12,0,0,edgeCount
824,149,193,graphml/GtsCe.graphml,2,1,clustered,0.6;-0.3,10,34,10,0,0,10,0,10,10,0,0,edgeCount
823,149,193,graphml/GtsCe.graphml,1,0,clustered,0.6;-0.3,12,12,12,0,0,12,0,12,12,0,0,edgeCount
822,149,193,graphml/GtsCe.graphml,1,0,clustered,0.6;-0.3,12,12,12,0,0,12,0,12,12,0,0,edgeCount
821,149,193,graphml/GtsCe.graphml,2,1,clustered,0.6;-0.3,25,25,10,15,0,25,15,25,25,15,0,edgeCount
820,149,193,graphml/GtsCe.graphml,3,2,clustered,0.6;-0.3,15,21,5,10,0,13,8,13,13,8,0,edgeCount
819,149,193,graphml/GtsCe.graphml,2,1,clustered,0.6;-0.3,60,60,20,40,0,60,40,60,60,40,0,edgeCount
818,149,193,graphml/GtsCe.graphml,1,0,clustered,0.6;-0.3,18,64,18,0,2,18,0,18,64,0,2,edgeCount
817,149,193,graphml/GtsCe.graphml,2,1,clustered,0.6;-0.3,33,33,11,22,0,33,22,33,33,22,0,edgeCount
816,149,193,graphml/GtsCe.graphml,2,1,clustered,0.6;-0.3,14,14,7,7,0,14,7,14,14,7,0,edgeCount
815,149,193,graphml/GtsCe.graphml,2,1,clustered,0.6;-0.3,12,12,12,0,4,12,0,12,12,0,4,edgeCount
814,149,193,graphml/GtsCe.graphml,2,1,clustered,0.6;-0.3,7,7,7,0,2,19,12,7,7,0,2,edgeCount
813,149,193,graphml/GtsCe.graphml,1,0,clustered,0.6;-0.3,15,15,15,0,0,15,0,15,15,0,0,edgeCount
811,149,193,graphml/GtsCe.graphml,1,0,clustered,0.6;-0.3,13,43,13,0,4,13,0,13,43,0,4,edgeCount
810,149,193,graphml/GtsCe.graphml,2,1,clustered,0.6;-0.3,-1,-1,9,-10,4,-1,-10,-1,-1,-10,4,edgeCount
809,149,193,graphml/GtsCe.graphml,2,1,clustered,0.6;-0.3,7,7,4,3,0,7,3,7,7,3,0,edgeCount
807,149,193,graphml/GtsCe.graphml,2,1,clustered,0.6;-0.3,8,8,7,1,2,8,1,24,8,17,2,edgeCount
805,149,193,graphml/GtsCe.graphml,1,0,clustered,0.6;-0.3,11,13,11,0,4,-1,-12,11,13,0,4,edgeCount
804,149,193,graphml/GtsCe.graphml,1,0,clustered,0.6;-0.3,7,7,7,0,0,7,0,7,7,0,0,edgeCount
802,149,193,graphml/GtsCe.graphml,2,1,clustered,0.6;-0.3,58,50,13,45,4,-1,-14,22,86,9,4,edgeCount
800,149,193,graphml/GtsCe.graphml,2,1,clustered,0.6;-0.3,10,10,10,0,0,10,0,10,10,0,0,edgeCount
799,149,193,graphml/GtsCe.graphml,2,1,clustered,0.6;-0.3,18,18,8,10,2,18,10,10,28,2,2,edgeCount
797,149,193,graphml/GtsCe.graphml,3,2,clustered,0.6;-0.3,30,30,9,21,0,30,21,30,30,21,0,edgeCount
795,149,193,graphml/GtsCe.graphml,2,1,clustered,0.6;-0.3,12,12,12,0,0,12,0,12,12,0,0,edgeCount
792,149,193,graphml/GtsCe.graphml,1,0,clustered,0.6;-0.3,9,27,9,0,2,9,0,9,27,0,2,edgeCount
791,149,193,graphml/GtsCe.graphml,1,0,clustered,0.6;-0.3,3,3,3,0,0,3,0,3,3,0,0,edgeCount
790,149,193,graphml/GtsCe.graphml,2,1,clustered,0.6;-0.3,11,47,7,4,0,11,4,11,11,4,0,edgeCount
789,149,193,graphml/GtsCe.graphml,3,2,clustered,0.6;-0.3,24,82,14,10,0,24,10,24,24,10,0,edgeCount
788,149,193,graphml/GtsCe.graphml,1,0,clustered,0.6;-0.3,12,12,12,0,0,12,0,12,12,0,0,edgeCount
787,149,193,graphml/GtsCe.graphml,2,1,clustered,0.6;-0.3,18,18,12,6,0,14,2,14,14,2,0,edgeCount
784,149,193,graphml/GtsCe.graphml,3,2,clustered,0.6;-0.3,23,23,7,16,0,23,16,23,23,16,0,edgeCount
782,149,193,graphml/GtsCe.graphml,2,1,clustered,0.6;-0.3,50,50,18,32,0,50,32,50,50,32,0,edgeCount
780,149,193,graphml/GtsCe.graphml,1,0,clustered,0.6;-0.3,6,6,6,0,0,6,0,6,6,0,0,edgeCount
779,149,193,graphml/GtsCe.graphml,1,0,clustered,0.6;-0.3,14,24,14,0,2,14,0,14,24,0,2,edgeCount
778,149,193,graphml/GtsCe.graphml,2,1,clustered,0.6;-0.3,4,4,4,0,0,4,0,4,4,0,0,edgeCount
777,149,193,graphml/GtsCe.graphml,2,1,clustered,0.6;-0.3,29,19,8,21,4,-1,-9,28,16,20,4,edgeCount
776,149,193,graphml/GtsCe.graphml,2,1,clustered,0.6;-0.3,62,62,18,44,0,62,44,62,62,44,0,edgeCount
774,149,193,graphml/GtsCe.graphml,2,1,clustered,0.6;-0.3,68,52,13,55,0,-1,-14,-1,-1,-14,0,edgeCount
773,149,193,graphml/GtsCe.graphml,1,0,clustered,0.6;-0.3,27,27,11,16,2,-1,-12,27,27,16,2,edgeCount
771,149,193,graphml/GtsCe.graphml,1,0,clustered,0.6;-0.3,14,40,14,0,2,14,0,14,40,0,2,edgeCount
770,149,193,graphml/GtsCe.graphml,3,2,clustered,0.6;-0.3,21,21,15,6,0,21,6,21,21,6,0,edgeCount
766,149,193,graphml/GtsCe.graphml,1,0,clustered,0.6;-0.3,12,36,12,0,6,12,0,12,36,0,6,edgeCount
765,149,193,graphml/GtsCe.graphml,3,2,clustered,0.6;-0.3,6,6,6,0,0,17,11,6,6,0,0,edgeCount
764,149,193,graphml/GtsCe.graphml,2,1,clustered,0.6;-0.3,6,6,6,0,0,6,0,6,6,0,0,edgeCount
762,149,193,graphml/GtsCe.graphml,2,1,clustered,0.6;-0.3,39,39,9,30,0,-1,-10,-1,-1,-10,0,edgeCount
761,149,193,graphml/GtsCe.graphml,2,1,clustered,0.6;-0.3,12,12,12,0,2,12,0,12,12,0,2,edgeCount
760,149,193,graphml/GtsCe.graphml,2,1,clustered,0.6;-0.3,54,54,14,40,0,54,40,54,54,40,0,edgeCount
759,149,193,graphml/GtsCe.graphml,2,1,clustered,0.6;-0.3,39,39,16,23,0,39,23,39,39,23,0,edgeCount
758,149,193,graphml/GtsCe.graphml,2,1,clustered,0.6;-0.3,15,15,9,6,0,15,6,15,15,6,0,edgeCount
756,149,193,graphml/GtsCe.graphml,1,0,clustered,0.6;-0.3,16,14,14,2,2,-1,-15,16,14,2,2,edgeCount
755,149,193,graphml/GtsCe.graphml,1,0,clustered,0.6;-0.3,13,25,13,0,4,13,0,13,25,0,4,edgeCount
754,149,193,graphml/GtsCe.graphml,2,1,clustered,0.6;-0.3,17,17,8,9,0,17,9,17,17,9,0,edgeCount
753,149,193,graphml/GtsCe.graphml,2,1,clustered,0.6;-0.3,9,9,8,1,2,9,1,9,9,1,2,edgeCount
751,149,193,graphml/GtsCe.graphml,2,1,clustered,0.6;-0.3,8,8,7,1,0,8,1,8,8,1,0,edgeCount
749,149,193,graphml/GtsCe.graphml,2,1,clustered,0.6;-0.3,43,43,17,26,0,43,26,43,43,26,0,edgeCount
748,149,193,graphml/GtsCe.graphml,3,2,clustered,0.6;-0.3,4,3,3,1,0,4,1,4,3,1,0,edgeCount
747,149,193,graphml/GtsCe.graphml,2,1,clustered,0.6;-0.3,40,40,12,28,6,-1,-13,40,14,28,6,edgeCount
746,149,193,graphml/GtsCe.graphml,2,1,clustered,0.6;-0.3,80,60,21,59,0,-1,-22,-1,-1,-22,0,edgeCount
744,149,193,graphml/GtsCe.graphml,1,0,clustered,0.6;-0.3,16,16,16,0,0,16,0,16,16,0,0,edgeCount
742,149,193,graphml/GtsCe.graphml,2,1,clustered,0.6;-0.3,11,11,10,1,0,11,1,11,11,1,0,edgeCount
741,149,193,graphml/GtsCe.graphml,2,1,clustered,0.6;-0.3,55,55,14,41,0,37,23,37,37,23,0,edgeCount
740,149,193,graphml/GtsCe.graphml,2,1,clustered,0.6;-0.3,26,26,10,16,0,26,16,26,26,16,0,edgeCount
739,149,193,graphml/GtsCe.graphml,2,1,clustered,0.6;-0.3,6,6,6,0,4,6,0,24,32,18,4,edgeCount
738,149,193,graphml/GtsCe.graphml,2,1,clustered,0.6;-0.3,50,50,18,32,6,50,32,26,46,8,6,edgeCount
737,149,193,graphml/GtsCe.graphml,2,1,clustered,0.6;-0.3,67,59,20,47,0,59,39,59,59,39,0,edgeCount
735,149,193,graphml/GtsCe.graphml,2,1,clustered,0.6;-0.3,9,9,9,0,2,9,0,9,9,0,2,edgeCount
733,149,193,graphml/GtsCe.graphml,2,1,clustered,0.6;-0.3,14,14,13,1,0,14,1,14,14,1,0,edgeCount
732,149,193,graphml/GtsCe.graphml,2,1,clustered,0.6;-0.3,12,12,12,0,0,12,0,12,12,0,0,edgeCount
731,149,193,graphml/GtsCe.graphml,2,1,clustered,0.6;-0.3,-1,-1,8,-9,0,-1,-9,-1,-1,-9,0,edgeCount
730,149,193,graphml/GtsCe.graphml,1,0,clustered,0.6;-0.3,11,29,11,0,2,11,0,11,29,0,2,edgeCount
729,149,193,graphml/GtsCe.graphml,2,1,clustered,0.6;-0.3,6,6,6,0,2,6,0,22,20,16,2,edgeCount
728,149,193,graphml/GtsCe.graphml,2,1,clustered,0.6;-0.3,2,2,2,0,0,2,0,2,2,0,0,edgeCount
727,149,193,graphml/GtsCe.graphml,1,0,clustered,0.6;-0.3,9,9,9,0,0,9,0,9,9,0,0,edgeCount
726,149,193,graphml/GtsCe.graphml,2,1,clustered,0.6;-0.3,-1,-1,9,-10,0,-1,-10,-1,-1,-10,0,edgeCount
722,149,193,graphml/GtsCe.graphml,2,1,clustered,0.6;-0.3,37,46,13,24,2,-1,-14,16,16,3,2,edgeCount
721,149,193,graphml/GtsCe.graphml,2,1,clustered,0.6;-0.3,41,41,17,24,0,41,24,41,41,24,0,edgeCount
720,149,193,graphml/GtsCe.graphml,2,1,clustered,0.6;-0.3,22,22,7,15,4,22,15,22,22,15,4,edgeCount
719,149,193,graphml/GtsCe.graphml,3,2,clustered,0.6;-0.3,13,13,5,8,0,13,8,13,13,8,0,edgeCount
718,149,193,graphml/GtsCe.graphml,2,1,clustered,0.6;-0.3,14,14,14,0,0,14,0,14,14,0,0,edgeCount
716,149,193,graphml/GtsCe.graphml,3,2,clustered,0.6;-0.3,56,56,14,42,4,-1,-15,58,24,44,4,edgeCount
714,149,193,graphml/GtsCe.graphml,2,1,clustered,0.6;-0.3,11,11,11,0,0,11,0,11,11,0,0,edgeCount
712,149,193,graphml/GtsCe.graphml,1,0,clustered,0.6;-0.3,10,20,10,0,4,10,0,10,20,0,4,edgeCount
711,149,193,graphml/GtsCe.graphml,2,1,clustered,0.6;-0.3,63,55,19,44,2,55,36,25,55,6,2,edgeCount
710,149,193,graphml/GtsCe.graphml,2,1,clustered,0.6;-0.3,19,19,19,0,0,19,0,19,19,0,0,edgeCount
709,149,193,graphml/GtsCe.graphml,2,1,clustered,0.6;-0.3,6,6,6,0,0,6,0,6,6,0,0,edgeCount
708,149,193,graphml/GtsCe.graphml,1,0,clustered,0.6;-0.3,32,32,14,18,4,-1,-15,32,32,18,4,edgeCount
706,149,193,graphml/GtsCe.graphml,2,1,clustered,0.6;-0.3,24,24,10,14,0,24,14,24,24,14,0,edgeCount
704,149,193,graphml/GtsCe.graphml,2,1,clustered,0.6;-0.3,11,11,8,3,0,29,21,11,11,3,0,edgeCount
703,149,193,graphml/GtsCe.graphml,1,0,clustered,0.6;-0.3,-1,-1,16,-17,2,-1,-17,-1,-1,-17,2,edgeCount
702,149,193,graphml/GtsCe.graphml,2,1,clustered,0.6;-0.3,6,6,6,0,0,6,0,6,6,0,0,edgeCount
701,149,193,graphml/GtsCe.graphml,2,1,clustered,0.6;-0.3,-1,-1,13,-14,0,-1,-14,-1,-1,-14,0,edgeCount
700,149,193,graphml/GtsCe.graphml,2,1,clustered,0.6;-0.3,8,8,8,0,2,8,0,8,8,0,2,edgeCount
699,149,193,graphml/GtsCe.graphml,2,1,clustered,0.6;-0.3,20,20,14,6,0,20,6,20,20,6,0,edgeCount
698,149,193,graphml/GtsCe.graphml,2,1,clustered,0.6;-0.3,4,4,4,0,0,4,0,4,4,0,0,edgeCount
696,149,193,graphml/GtsCe.graphml,2,1,clustered,0.6;-0.3,-1,-1,12,-13,0,-1,-13,-1,-1,-13,0,edgeCount
695,149,193,graphml/GtsCe.graphml,2,1,clustered,0.6;-0.3,11,11,11,0,0,11,0,11,11,0,0,edgeCount
691,149,193,graphml/GtsCe.graphml,2,1,clustered,0.6;-0.3,7,7,7,0,0,7,0,7,7,0,0,edgeCount
690,149,193,graphml/GtsCe.graphml,2,1,clustered,0.6;-0.3,11,11,11,0,0,11,0,11,11,0,0,edgeCount
689,149,193,graphml/GtsCe.graphml,2,1,clustered,0.6;-0.3,15,15,14,1,0,15,1,15,15,1,0,edgeCount
687,149,193,graphml/GtsCe.graphml,3,2,clustered,0.6;-0.3,6,6,5,1,0,6,1,6,6,1,0,edgeCount
685,149,193,graphml/GtsCe.graphml,2,1,clustered,0.6;-0.3,4,4,4,0,4,4,0,4,4,0,4,edgeCount
684,149,193,graphml/GtsCe.graphml,2,1,clustered,0.6;-0.3,-1,-1,8,-9,2,-1,-9,-1,-1,-9,2,edgeCount
682,149,193,graphml/GtsCe.graphml,1,0,clustered,0.6;-0.3,13,13,13,0,0,13,0,13,13,0,0,edgeCount
681,149,193,graphml/GtsCe.graphml,2,1,clustered,0.6;-0.3,63,63,16,47,0,63,47,63,63,47,0,edgeCount
680,149,193,graphml/GtsCe.graphml,1,0,clustered,0.6;-0.3,9,9,9,0,0,9,0,9,9,0,0,edgeCount
679,149,193,graphml/GtsCe.graphml,1,0,clustered,0.6;-0.3,8,8,8,0,2,8,0,8,8,0,2,edgeCount
678,149,193,graphml/GtsCe.graphml,2,1,clustered,0.6;-0.3,10,10,10,0,0,32,22,10,10,0,0,edgeCount
677,149,193,graphml/GtsCe.graphml,1,0,clustered,0.6;-0.3,9,9,9,0,0,9,0,9,9,0,0,edgeCount
676,149,193,graphml/GtsCe.graphml,2,1,clustered,0.6;-0.3,7,7,7,0,0,-1,-8,7,7,0,0,edgeCount
675,149,193,graphml/GtsCe.graphml,3,2,clustered,0.6;-0.3,14,14,10,4,0,14,4,14,14,4,0,edgeCount
673,149,193,graphml/GtsCe.graphml,2,1,clustered,0.6;-0.3,31,31,13,18,0,31,18,31,31,18,0,edgeCount
672,149,193,graphml/GtsCe.graphml,1,0,clustered,0.6;-0.3,20,20,10,10,2,-1,-11,20,20,10,2,edgeCount
671,149,193,graphml/GtsCe.graphml,2,1,clustered,0.6;-0.3,14,14,14,0,0,54,40,54,54,40,0,edgeCount
669,149,193,graphml/GtsCe.graphml,2,1,clustered,0.6;-0.3,38,38,14,24,2,38,24,38,38,24,2,edgeCount
668,149,193,graphml/GtsCe.graphml,3,2,clustered,0.6;-0.3,-1,-1,7,-8,0,-1,-8,-1,-1,-8,0,edgeCount
667,149,193,graphml/GtsCe.graphml,2,1,clustered,0.6;-0.3,7,7,7,0,0,-1,-8,7,7,0,0,edgeCount
666,149,193,graphml/GtsCe.graphml,2,1,clustered,0.6;-0.3,51,51,18,33,0,-1,-19,-1,-1,-19,0,edgeCount
665,149,193,graphml/GtsCe.graphml,2,1,clustered,0.6;-0.3,12,12,12,0,4,12,0,42,12,30,4,edgeCount
664,149,193,graphml/GtsCe.graphml,2,1,clustered,0.6;-0.3,-1,-1,19,-20,0,-1,-20,-1,-1,-20,0,edgeCount
663,149,193,graphml/GtsCe.graphml,2,1,clustered,0.6;-0.3,29,33,11,18,2,29,18,11,12,0,2,edgeCount
662,149,193,graphml/GtsCe.graphml,1,0,clustered,0.6;-0.3,2,2,2,0,0,2,0,2,2,0,0,edgeCount
661,149,193,graphml/GtsCe.graphml,1,0,clustered,0.6;-0.3,11,11,11,0,0,11,0,11,11,0,0,edgeCount
659,149,193,graphml/GtsCe.graphml,2,1,clustered,0.6;-0.3,14,18,6,8,4,14,8,14,14,8,4,edgeCount
658,149,193,graphml/GtsCe.graphml,2,1,clustered,0.6;-0.3,6,6,6,0,2,6,0,6,6,0,2,edgeCount
657,149,193,graphml/GtsCe.graphml,2,1,clustered,0.6;-0.3,23,23,11,12,0,17,6,17,17,6,0,edgeCount
655,149,193,graphml/GtsCe.graphml,2,1,clustered,0.6;-0.3,45,33,21,24,8,-1,-22,-1,-1,-22,8,edgeCount
653,149,193,graphml/GtsCe.graphml,2,1,clustered,0.6;-0.3,42,66,11,31,4,42,31,42,42,31,4,edgeCount
652,149,193,graphml/GtsCe.graphml,2,1,clustered,0.6;-0.3,20,8,8,12,2,8,0,8,20,0,2,edgeCount
650,149,193,graphml/GtsCe.graphml,2,1,clustered,0.6;-0.3,4,4,4,0,0,4,0,4,4,0,0,edgeCount
649,149,193,graphml/GtsCe.graphml,2,1,clustered,0.6;-0.3,7,7,7,0,0,7,0,7,7,0,0,edgeCount
648,149,193,graphml/GtsCe.graphml,2,1,clustered,0.6;-0.3,9,9,9,0,0,9,0,9,9,0,0,edgeCount
647,149,193,graphml/GtsCe.graphml,1,0,clustered,0.6;-0.3,5,5,5,0,0,5,0,5,5,0,0,edgeCount
646,149,193,graphml/GtsCe.graphml,3,2,clustered,0.6;-0.3,23,19,7,16,0,-1,-8,-1,-1,-8,0,edgeCount
645,149,193,graphml/GtsCe.graphml,1,0,clustered,0.6;-0.3,-1,-1,7,-8,0,-1,-8,-1,-1,-8,0,edgeCount
644,149,193,graphml/GtsCe.graphml,1,0,clustered,0.6;-0.3,14,12,9,5,4,-1,-10,14,12,5,4,edgeCount
643,149,193,graphml/GtsCe.graphml,2,1,clustered,0.6;-0.3,35,61,15,20,8,35,20,35,35,20,8,edgeCount
642,149,193,graphml/GtsCe.graphml,3,2,clustered,0.6;-0.3,28,28,6,22,0,28,22,28,28,22,0,edgeCount
641,149,193,graphml/GtsCe.graphml,1,0,clustered,0.6;-0.3,10,10,10,0,0,10,0,10,10,0,0,edgeCount
640,149,193,graphml/GtsCe.graphml,2,1,clustered,0.6;-0.3,35,35,13,22,6,-1,-14,40,28,27,6,edgeCount
639,149,193,graphml/GtsCe.graphml,2,1,clustered,0.6;-0.3,-1,-1,12,-13,0,-1,-13,-1,-1,-13,0,edgeCount
638,149,193,graphml/GtsCe.graphml,2,1,clustered,0.6;-0.3,-1,-1,9,-10,0,-1,-10,-1,-1,-10,0,edgeCount
636,149,193,graphml/GtsCe.graphml,1,0,clustered,0.6;-0.3,11,11,11,0,0,11,0,11,11,0,0,edgeCount
635,149,193,graphml/GtsCe.graphml,1,0,clustered,0.6;-0.3,-1,-1,15,-16,2,-1,-16,-1,-1,-16,2,edgeCount
634,149,193,graphml/GtsCe.graphml,2,1,clustered,0.6;-0.3,45,33,15,30,6,-1,-16,39,15,24,6,edgeCount
633,149,193,graphml/GtsCe.graphml,2,1,clustered,0.6;-0.3,17,17,9,8,0,17,8,17,17,8,0,edgeCount
632,149,193,graphml/GtsCe.graphml,1,0,clustered,0.6;-0.3,20,20,20,0,4,-1,-21,20,20,0,4,edgeCount
631,149,193,graphml/GtsCe.graphml,2,1,clustered,0.6;-0.3,12,12,12,0,2,12,0,18,26,6,2,edgeCount
630,149,193,graphml/GtsCe.graphml,2,1,clustered,0.6;-0.3,13,13,13,0,0,13,0,13,13,0,0,edgeCount
627,149,193,graphml/GtsCe.graphml,2,1,clustered,0.6;-0.3,43,37,11,32,0,37,26,37,37,26,0,edgeCount
626,149,193,graphml/GtsCe.graphml,2,1,clustered,0.6;-0.3,11,11,6,5,0,11,5,11,11,5,0,edgeCount
624,149,193,graphml/GtsCe.graphml,3,2,clustered,0.6;-0.3,74,74,14,60,4,-1,-15,74,74,60,4,edgeCount
622,149,193,graphml/GtsCe.graphml,3,2,clustered,0.6;-0.3,70,70,12,58,2,-1,-13,41,15,29,2,edgeCount
620,149,193,graphml/GtsCe.graphml,2,1,clustered,0.6;-0.3,14,14,8,6,0,14,6,14,14,6,0,edgeCount
617,149,193,graphml/GtsCe.graphml,2,1,clustered,0.6;-0.3,53,35,17,36,0,35,18,35,35,18,0,edgeCount
615,149,193,graphml/GtsCe.graphml,3,2,clustered,0.6;-0.3,6,6,6,0,0,6,0,6,6,0,0,edgeCount
614,149,193,graphml/GtsCe.graphml,3,2,clustered,0.6;-0.3,34,68,8,26,6,32,24,24,32,16,6,edgeCount
613,149,193,graphml/GtsCe.graphml,1,0,clustered,0.6;-0.3,14,14,14,0,0,14,0,14,14,0,0,edgeCount
612,149,193,graphml/GtsCe.graphml,2,1,clustered,0.6;-0.3,36,56,10,26,6,-1,-11,15,15,5,6,edgeCount
611,149,193,graphml/GtsCe.graphml,1,0,clustered,0.6;-0.3,3,3,3,0,4,3,0,3,3,0,4,edgeCount
609,149,193,graphml/GtsCe.graphml,3,2,clustered,0.6;-0.3,68,68,14,54,0,68,54,68,68,54,0,edgeCount
608,149,193,graphml/GtsCe.graphml,1,0,clustered,0.6;-0.3,22,22,20,2,4,-1,-21,22,22,2,4,edgeCount
605,149,193,graphml/GtsCe.graphml,2,1,clustered,0.6;-0.3,15,15,9,6,0,15,6,15,15,6,0,edgeCount
604,149,193,graphml/GtsCe.graphml,1,0,clustered,0.6;-0.3,-1,-1,6,-7,4,-1,-7,-1,-1,-7,4,edgeCount
603,149,193,graphml/GtsCe.graphml,2,1,clustered,0.6;-0.3,2,2,2,0,0,2,0,2,2,0,0,edgeCount
602,149,193,graphml/GtsCe.graphml,1,0,clustered,0.6;-0.3,6,6,6,0,2,6,0,6,6,0,2,edgeCount
601,149,193,graphml/GtsCe.graphml,1,0,clustered,0.6;-0.3,6,6,6,0,0,6,0,6,6,0,0,edgeCount
599,149,193,graphml/GtsCe.graphml,2,1,clustered,0.6;-0.3,6,6,6,0,0,6,0,6,6,0,0,edgeCount
597,149,193,graphml/GtsCe.graphml,1,0,clustered,0.6;-0.3,19,19,19,0,0,19,0,19,19,0,0,edgeCount
596,149,193,graphml/GtsCe.graphml,2,1,clustered,0.6;-0.3,2,2,2,0,0,2,0,2,2,0,0,edgeCount
595,149,193,graphml/GtsCe.graphml,2,1,clustered,0.6;-0.3,3,3,3,0,0,3,0,3,3,0,0,edgeCount
594,149,193,graphml/GtsCe.graphml,2,1,clustered,0.6;-0.3,9,9,9,0,2,9,0,27,9,18,2,edgeCount
593,149,193,graphml/GtsCe.graphml,2,1,clustered,0.6;-0.3,65,65,16,49,0,65,49,65,65,49,0,edgeCount
592,149,193,graphml/GtsCe.graphml,2,1,clustered,0.6;-0.3,5,5,5,0,0,5,0,5,5,0,0,edgeCount
591,149,193,graphml/GtsCe.graphml,2,1,clustered,0.6;-0.3,16,34,6,10,0,16,10,16,16,10,0,edgeCount
590,149,193,graphml/GtsCe.graphml,1,0,clustered,0.6;-0.3,8,8,8,0,0,8,0,8,8,0,0,edgeCount
589,149,193,graphml/GtsCe.graphml,2,1,clustered,0.6;-0.3,10,10,9,1,0,10,1,10,10,1,0,edgeCount
588,149,193,graphml/GtsCe.graphml,2,1,clustered,0.6;-0.3,26,26,10,16,0,26,16,26,26,16,0,edgeCount
587,149,193,graphml/GtsCe.graphml,2,1,clustered,0.6;-0.3,14,14,5,9,0,14,9,14,14,9,0,edgeCount
586,149,193,graphml/GtsCe.graphml,2,1,clustered,0.6;-0.3,10,10,10,0,6,10,0,46,38,36,6,edgeCount
584,149,193,graphml/GtsCe.graphml,2,1,clustered,0.6;-0.3,9,9,9,0,0,9,0,9,9,0,0,edgeCount
580,149,193,graphml/GtsCe.graphml,2,1,clustered,0.6;-0.3,5,5,5,0,2,5,0,6,5,1,2,edgeCount
578,149,193,graphml/GtsCe.graphml,2,1,clustered,0.6;-0.3,40,34,19,21,2,-1,-20,-1,-1,-20,2,edgeCount
577,149,193,graphml/GtsCe.graphml,1,0,clustered,0.6;-0.3,18,26,18,0,2,18,0,18,26,0,2,edgeCount
576,149,193,graphml/GtsCe.graphml,2,1,clustered,0.6;-0.3,21,21,11,10,0,-1,-12,-1,-1,-12,0,edgeCount
574,149,193,graphml/GtsCe.graphml,1,0,clustered,0.6;-0.3,11,11,11,0,0,11,0,11,11,0,0,edgeCount
573,149,193,graphml/GtsCe.graphml,1,0,clustered,0.6;-0.3,13,13,13,0,0,13,0,13,13,0,0,edgeCount
572,149,193,graphml/GtsCe.graphml,2,1,clustered,0.6;-0.3,12,12,12,0,0,12,0,12,12,0,0,edgeCount
571,149,193,graphml/GtsCe.graphml,2,1,clustered,0.6;-0.3,21,21,10,11,0,19,9,19,19,9,0,edgeCount
569,149,193,graphml/GtsCe.graphml,1,0,clustered,0.6;-0.3,20,20,20,0,0,20,0,20,20,0,0,edgeCount
568,149,193,graphml/GtsCe.graphml,2,1,clustered,0.6;-0.3,3,3,3,0,0,3,0,3,3,0,0,edgeCount
567,149,193,graphml/GtsCe.graphml,2,1,clustered,0.6;-0.3,23,23,11,12,6,23,12,25,25,14,6,edgeCount
565,149,193,graphml/GtsCe.graphml,2,1,clustered,0.6;-0.3,23,23,12,11,0,23,11,23,23,11,0,edgeCount
564,149,193,graphml/GtsCe.graphml,2,1,clustered,0.6;-0.3,47,47,18,29,0,47,29,47,47,29,0,edgeCount
563,149,193,graphml/GtsCe.graphml,2,1,clustered,0.6;-0.3,34,38,16,18,2,34,18,34,38,18,2,edgeCount
561,149,193,graphml/GtsCe.graphml,2,1,clustered,0.6;-0.3,5,19,4,1,0,5,1,5,5,1,0,edgeCount
560,149,193,graphml/GtsCe.graphml,3,2,clustered,0.6;-0.3,8,8,6,2,0,8,2,8,8,2,0,edgeCount
559,149,193,graphml/GtsCe.graphml,1,0,clustered,0.6;-0.3,22,22,18,4,6,-1,-19,22,22,4,6,edgeCount
558,149,193,graphml/GtsCe.graphml,2,1,clustered,0.6;-0.3,9,9,9,0,0,9,0,9,9,0,0,edgeCount
556,149,193,graphml/GtsCe.graphml,2,1,clustered,0.6;-0.3,45,65,12,33,0,45,33,45,45,33,0,edgeCount
555,149,193,graphml/GtsCe.graphml,2,1,clustered,0.6;-0.3,2,2,2,0,2,2,0,2,2,0,2,edgeCount
554,149,193,graphml/GtsCe.graphml,1,0,clustered,0.6;-0.3,20,14,9,11,6,-1,-10,20,14,11,6,edgeCount
553,149,193,graphml/GtsCe.graphml,2,1,clustered,0.6;-0.3,50,84,15,35,2,50,35,22,78,7,2,edgeCount
552,149,193,graphml/GtsCe.graphml,1,0,clustered,0.6;-0.3,11,11,11,0,2,11,0,11,11,0,2,edgeCount
551,149,193,graphml/GtsCe.graphml,1,0,clustered,0.6;-0.3,34,34,10,24,2,-1,-11,34,34,24,2,edgeCount
550,149,193,graphml/GtsCe.graphml,2,1,clustered,0.6;-0.3,42,42,10,32,0,42,32,42,42,32,0,edgeCount
549,149,193,graphml/GtsCe.graphml,2,1,clustered,0.6;-0.3,52,44,16,36,0,44,28,44,44,28,0,edgeCount
548,149,193,graphml/GtsCe.graphml,2,1,clustered,0.6;-0.3,8,9,8,0,6,8,0,8,8,0,6,edgeCount
547,149,193,graphml/GtsCe.graphml,2,1,clustered,0.6;-0.3,10,10,10,0,0,10,0,10,10,0,0,edgeCount
546,149,193,graphml/GtsCe.graphml,2,1,clustered,0.6;-0.3,9,9,9,0,2,9,0,9,9,0,2,edgeCount
545,149,193,graphml/GtsCe.graphml,2,1,clustered,0.6;-0.3,3,3,3,0,0,3,0,3,3,0,0,edgeCount
543,149,193,graphml/GtsCe.graphml,2,1,clustered,0.6;-0.3,-1,-1,13,-14,0,-1,-14,-1,-1,-14,0,edgeCount
542,149,193,graphml/GtsCe.graphml,2,1,clustered,0.6;-0.3,32,32,15,17,0,32,17,32,32,17,0,edgeCount
541,149,193,graphml/GtsCe.graphml,2,1,clustered,0.6;-0.3,17,17,6,11,0,7,1,17,17,11,0,edgeCount
540,149,193,graphml/GtsCe.graphml,2,1,clustered,0.6;-0.3,39,33,13,26,2,-1,-14,39,33,26,2,edgeCount
539,149,193,graphml/GtsCe.graphml,2,1,clustered,0.6;-0.3,14,14,5,9,2,-1,-6,5,5,0,2,edgeCount
538,149,193,graphml/GtsCe.graphml,2,1,clustered,0.6;-0.3,9,9,9,0,0,-1,-10,9,9,0,0,edgeCount
537,149,193,graphml/GtsCe.graphml,1,0,clustered,0.6;-0.3,22,22,12,10,2,12,0,22,22,10,2,edgeCount
536,149,193,graphml/GtsCe.graphml,3,2,clustered,0.6;-0.3,5,5,4,1,0,19,15,5,5,1,0,edgeCount
534,149,193,graphml/GtsCe.graphml,2,1,clustered,0.6;-0.3,41,15,14,27,0,15,1,15,15,1,0,edgeCount
533,149,193,graphml/GtsCe.graphml,2,1,clustered,0.6;-0.3,9,8,8,1,0,21,13,21,21,13,0,edgeCount
532,149,193,graphml/GtsCe.graphml,2,1,clustered,0.6;-0.3,-1,-1,10,-11,0,-1,-11,-1,-1,-11,0,edgeCount
530,149,193,graphml/GtsCe.graphml,2,1,clustered,0.6;-0.3,10,8,4,6,0,-1,-5,-1,-1,-5,0,edgeCount
529,149,193,graphml/GtsCe.graphml,2,1,clustered,0.6;-0.3,36,36,17,19,0,36,19,36,36,19,0,edgeCount
528,149,193,graphml/GtsCe.graphml,1,0,clustered,0.6;-0.3,11,11,11,0,0,11,0,11,11,0,0,edgeCount
527,149,193,graphml/GtsCe.graphml,2,1,clustered,0.6;-0.3,12,12,12,0,0,40,28,12,12,0,0,edgeCount
526,149,193,graphml/GtsCe.graphml,1,0,clustered,0.6;-0.3,6,6,6,0,0,6,0,6,6,0,0,edgeCount
525,149,193,graphml/GtsCe.graphml,2,1,clustered,0.6;-0.3,5,3,3,2,4,3,0,5,3,2,4,edgeCount
523,149,193,graphml/GtsCe.graphml,3,2,clustered,0.6;-0.3,4,4,4,0,0,5,1,4,4,0,0,edgeCount
521,149,193,graphml/GtsCe.graphml,2,1,clustered,0.6;-0.3,-1,-1,8,-9,0,-1,-9,-1,-1,-9,0,edgeCount
519,149,193,graphml/GtsCe.graphml,2,1,clustered,0.6;-0.3,-1,-1,6,-7,2,-1,-7,-1,-1,-7,2,edgeCount
518,149,193,graphml/GtsCe.graphml,2,1,clustered,0.6;-0.3,19,19,10,9,0,19,9,19,19,9,0,edgeCount
517,149,193,graphml/GtsCe.graphml,2,1,clustered,0.6;-0.3,10,10,10,0,0,10,0,10,10,0,0,edgeCount
516,149,193,graphml/GtsCe.graphml,3,2,clustered,0.6;-0.3,7,7,7,0,0,7,0,7,7,0,0,edgeCount
515,149,193,graphml/GtsCe.graphml,2,1,clustered,0.6;-0.3,13,39,10,3,2,35,25,13,39,3,2,edgeCount
514,149,193,graphml/GtsCe.graphml,2,1,clustered,0.6;-0.3,16,16,15,1,0,16,1,16,16,1,0,edgeCount
513,149,193,graphml/GtsCe.graphml,3,2,clustered,0.6;-0.3,8,8,8,0,0,8,0,8,8,0,0,edgeCount
512,149,193,graphml/GtsCe.graphml,1,0,clustered,0.6;-0.3,16,70,16,0,6,16,0,16,70,0,6,edgeCount
511,149,193,graphml/GtsCe.graphml,2,1,clustered,0.6;-0.3,2,2,2,0,6,2,0,2,2,0,6,edgeCount
510,149,193,graphml/GtsCe.graphml,2,1,clustered,0.6;-0.3,26,26,9,17,0,26,17,26,26,17,0,edgeCount
508,149,193,graphml/GtsCe.graphml,2,1,clustered,0.6;-0.3,4,2,2,2,0,4,2,4,4,2,0,edgeCount
507,149,193,graphml/GtsCe.graphml,2,1,clustered,0.6;-0.3,25,25,11,14,6,-1,-12,-1,-1,-12,6,edgeCount
506,149,193,graphml/GtsCe.graphml,1,0,clustered,0.6;-0.3,7,7,7,0,0,7,0,7,7,0,0,edgeCount
505,149,193,graphml/GtsCe.graphml,2,1,clustered,0.6;-0.3,8,8,8,0,4,8,0,8,8,0,4,edgeCount
504,149,193,graphml/GtsCe.graphml,2,1,clustered,0.6;-0.3,13,13,13,0,0,37,24,13,13,0,0,edgeCount
503,149,193,graphml/GtsCe.graphml,2,1,clustered,0.6;-0.3,16,23,5,11,2,6,1,6,10,1,2,edgeCount
502,149,193,graphml/GtsCe.graphml,2,1,clustered,0.6;-0.3,6,6,4,2,0,-1,-5,-1,-1,-5,0,edgeCount
500,149,193,graphml/GtsCe.graphml,2,1,clustered,0.6;-0.3,6,6,6,0,0,6,0,6,6,0,0,edgeCount
499,149,193,graphml/GtsCe.graphml,2,1,clustered,0.6;-0.3,42,40,12,30,2,-1,-13,-1,-1,-13,2,edgeCount
496,149,193,graphml/GtsCe.graphml,1,0,clustered,0.6;-0.3,3,3,3,0,0,3,0,3,3,0,0,edgeCount
495,149,193,graphml/GtsCe.graphml,2,1,clustered,0.6;-0.3,6,6,6,0,2,-1,-7,6,6,0,2,edgeCount
494,149,193,graphml/GtsCe.graphml,2,1,clustered,0.6;-0.3,27,27,10,17,0,27,17,27,27,17,0,edgeCount
490,149,193,graphml/GtsCe.graphml,2,1,clustered,0.6;-0.3,7,7,7,0,0,7,0,7,7,0,0,edgeCount
489,149,193,graphml/GtsCe.graphml,2,1,clustered,0.6;-0.3,7,7,4,3,2,7,3,5,10,1,2,edgeCount
488,149,193,graphml/GtsCe.graphml,2,1,clustered,0.6;-0.3,32,32,9,23,2,32,23,32,32,23,2,edgeCount
487,149,193,graphml/GtsCe.graphml,1,0,clustered,0.6;-0.3,15,15,15,0,0,15,0,15,15,0,0,edgeCount
486,149,193,graphml/GtsCe.graphml,2,1,clustered,0.6;-0.3,2,2,2,0,0,2,0,2,2,0,0,edgeCount
484,149,193,graphml/GtsCe.graphml,2,1,clustered,0.6;-0.3,8,8,8,0,0,8,0,8,8,0,0,edgeCount
483,149,193,graphml/GtsCe.graphml,2,1,clustered,0.6;-0.3,14,14,12,2,0,45,33,14,14,2,0,edgeCount
481,149,193,graphml/GtsCe.graphml,1,0,clustered,0.6;-0.3,7,7,7,0,0,7,0,7,7,0,0,edgeCount
480,149,193,graphml/GtsCe.graphml,2,1,clustered,0.6;-0.3,39,39,16,23,0,-1,-17,-1,-1,-17,0,edgeCount
479,149,193,graphml/GtsCe.graphml,1,0,clustered,0.6;-0.3,11,11,11,0,2,11,0,11,11,0,2,edgeCount
478,149,193,graphml/GtsCe.graphml,2,1,clustered,0.6;-0.3,26,18,7,19,2,-1,-8,21,15,14,2,edgeCount
473,149,193,graphml/GtsCe.graphml,1,0,clustered,0.6;-0.3,33,19,19,14,2,-1,-20,33,19,14,2,edgeCount
471,149,193,graphml/GtsCe.graphml,2,1,clustered,0.6;-0.3,45,45,13,32,0,45,32,45,45,32,0,edgeCount
470,149,193,graphml/GtsCe.graphml,2,1,clustered,0.6;-0.3,-1,-1,10,-11,0,-1,-11,-1,-1,-11,0,edgeCount
469,149,193,graphml/GtsCe.graphml,3,2,clustered,0.6;-0.3,3,3,3,0,2,4,1,4,3,1,2,edgeCount
467,149,193,graphml/GtsCe.graphml,2,1,clustered,0.6;-0.3,14,14,14,0,0,14,0,14,14,0,0,edgeCount
466,149,193,graphml/GtsCe.graphml,2,1,clustered,0.6;-0.3,4,4,4,0,8,17,13,7,26,3,8,edgeCount
465,149,193,graphml/GtsCe.graphml,2,1,clustered,0.6;-0.3,34,41,11,23,2,34,23,34,34,23,2,edgeCount
464,149,193,graphml/GtsCe.graphml,2,1,clustered,0.6;-0.3,33,33,12,21,0,33,21,33,33,21,0,edgeCount
463,149,193,graphml/GtsCe.graphml,1,0,clustered,0.6;-0.3,17,17,17,0,4,17,0,17,17,0,4,edgeCount
462,149,193,graphml/GtsCe.graphml,2,1,clustered,0.6;-0.3,3,3,3,0,2,3,0,3,3,0,2,edgeCount
461,149,193,graphml/GtsCe.graphml,2,1,clustered,0.6;-0.3,-1,-1,23,-24,2,-1,-24,-1,-1,-24,2,edgeCount
460,149,193,graphml/GtsCe.graphml,2,1,clustered,0.6;-0.3,13,13,9,4,0,13,4,13,13,4,0,edgeCount
458,149,193,graphml/GtsCe.graphml,2,1,clustered,0.6;-0.3,-1,-1,18,-19,0,-1,-19,-1,-1,-19,0,edgeCount
457,149,193,graphml/GtsCe.graphml,2,1,clustered,0.6;-0.3,5,5,5,0,0,5,0,5,5,0,0,edgeCount
455,149,193,graphml/GtsCe.graphml,2,1,clustered,0.6;-0.3,15,15,12,3,0,15,3,15,15,3,0,edgeCount
454,149,193,graphml/GtsCe.graphml,2,1,clustered,0.6;-0.3,8,8,8,0,2,8,0,8,8,0,2,edgeCount
453,149,193,graphml/GtsCe.graphml,2,1,clustered,0.6;-0.3,39,39,10,29,4,-1,-11,32,14,22,4,edgeCount
452,149,193,graphml/GtsCe.graphml,2,1,clustered,0.6;-0.3,7,7,5,2,0,-1,-6,-1,-1,-6,0,edgeCount
451,149,193,graphml/GtsCe.graphml,2,1,clustered,0.6;-0.3,14,14,14,0,2,14,0,14,14,0,2,edgeCount
449,149,193,graphml/GtsCe.graphml,2,1,clustered,0.6;-0.3,3,3,3,0,0,3,0,3,3,0,0,edgeCount
448,149,193,graphml/GtsCe.graphml,1,0,clustered,0.6;-0.3,6,8,6,0,4,-1,-7,6,8,0,4,edgeCount
446,149,193,graphml/GtsCe.graphml,2,1,clustered,0.6;-0.3,7,7,7,0,6,7,0,7,7,0,6,edgeCount
445,149,193,graphml/GtsCe.graphml,2,1,clustered,0.6;-0.3,10,10,5,5,0,10,5,10,10,5,0,edgeCount
444,149,193,graphml/GtsCe.graphml,2,1,clustered,0.6;-0.3,28,16,16,12,0,28,12,28,16,12,0,edgeCount
443,149,193,graphml/GtsCe.graphml,1,0,clustered,0.6;-0.3,33,19,14,19,8,-1,-15,33,19,19,8,edgeCount
441,149,193,graphml/GtsCe.graphml,2,1,clustered,0.6;-0.3,12,12,12,0,8,12,0,52,12,40,8,edgeCount
438,149,193,graphml/GtsCe.graphml,2,1,clustered,0.6;-0.3,18,18,11,7,0,18,7,18,18,7,0,edgeCount
435,149,193,graphml/GtsCe.graphml,2,1,clustered,0.6;-0.3,11,11,9,2,2,27,18,11,47,2,2,edgeCount
434,149,193,graphml/GtsCe.graphml,3,2,clustered,0.6;-0.3,102,114,13,89,2,102,89,66,30,53,2,edgeCount
432,149,193,graphml/GtsCe.graphml,2,1,clustered,0.6;-0.3,5,5,5,0,0,5,0,5,5,0,0,edgeCount
431,149,193,graphml/GtsCe.graphml,2,1,clustered,0.6;-0.3,49,79,18,31,0,49,31,49,49,31,0,edgeCount
429,149,193,graphml/GtsCe.graphml,2,1,clustered,0.6;-0.3,15,15,13,2,0,15,2,15,15,2,0,edgeCount
428,149,193,graphml/GtsCe.graphml,1,0,clustered,0.6;-0.3,-1,-1,17,-18,0,-1,-18,-1,-1,-18,0,edgeCount
427,149,193,graphml/GtsCe.graphml,1,0,clustered,0.6;-0.3,-1,-1,14,-15,2,-1,-15,-1,-1,-15,2,edgeCount
426,149,193,graphml/GtsCe.graphml,2,1,clustered,0.6;-0.3,6,6,6,0,0,6,0,6,6,0,0,edgeCount
425,149,193,graphml/GtsCe.graphml,2,1,clustered,0.6;-0.3,-1,-1,13,-14,0,-1,-14,-1,-1,-14,0,edgeCount
424,149,193,graphml/GtsCe.graphml,2,1,clustered,0.6;-0.3,6,6,6,0,2,6,0,6,6,0,2,edgeCount
423,149,193,graphml/GtsCe.graphml,1,0,clustered,0.6;-0.3,14,14,14,0,0,14,0,14,14,0,0,edgeCount
421,149,193,graphml/GtsCe.graphml,2,1,clustered,0.6;-0.3,20,20,19,1,0,20,1,20,20,1,0,edgeCount
419,149,193,graphml/GtsCe.graphml,2,1,clustered,0.6;-0.3,7,7,7,0,0,7,0,7,7,0,0,edgeCount
417,149,193,graphml/GtsCe.graphml,1,0,clustered,0.6;-0.3,18,18,18,0,0,18,0,18,18,0,0,edgeCount
416,149,193,graphml/GtsCe.graphml,1,0,clustered,0.6;-0.3,-1,-1,7,-8,4,-1,-8,-1,-1,-8,4,edgeCount
415,149,193,graphml/GtsCe.graphml,3,2,clustered,0.6;-0.3,22,22,8,14,0,22,14,22,22,14,0,edgeCount
414,149,193,graphml/GtsCe.graphml,2,1,clustered,0.6;-0.3,8,8,6,2,0,8,2,8,8,2,0,edgeCount
413,149,193,graphml/GtsCe.graphml,3,2,clustered,0.6;-0.3,22,22,6,16,0,-1,-7,-1,-1,-7,0,edgeCount
412,149,193,graphml/GtsCe.graphml,2,1,clustered,0.6;-0.3,13,13,12,1,0,13,1,13,13,1,0,edgeCount
407,149,193,graphml/GtsCe.graphml,2,1,clustered,0.6;-0.3,12,12,12,0,0,12,0,12,12,0,0,edgeCount
406,149,193,graphml/GtsCe.graphml,2,1,clustered,0.6;-0.3,35,35,13,22,0,35,22,35,35,22,0,edgeCount
405,149,193,graphml/GtsCe.graphml,2,1,clustered,0.6;-0.3,4,4,4,0,0,4,0,4,4,0,0,edgeCount
404,149,193,graphml/GtsCe.graphml,2,1,clustered,0.6;-0.3,29,27,13,16,8,-1,-14,26,36,13,8,edgeCount
403,149,193,graphml/GtsCe.graphml,2,1,clustered,0.6;-0.3,23,45,15,8,0,23,8,23,23,8,0,edgeCount
402,149,193,graphml/GtsCe.graphml,1,0,clustered,0.6;-0.3,7,35,7,0,2,7,0,7,35,0,2,edgeCount
401,149,193,graphml/GtsCe.graphml,2,1,clustered,0.6;-0.3,54,42,14,40,2,-1,-15,52,24,38,2,edgeCount
400,149,193,graphml/GtsCe.graphml,2,1,clustered,0.6;-0.3,14,14,8,6,0,14,6,14,14,6,0,edgeCount
399,149,193,graphml/GtsCe.graphml,2,1,clustered,0.6;-0.3,6,6,5,1,0,6,1,6,6,1,0,edgeCount
397,149,193,graphml/GtsCe.graphml,2,1,clustered,0.6;-0.3,27,27,13,14,0,21,8,21,21,8,0,edgeCount
396,149,193,graphml/GtsCe.graphml,2,1,clustered,0.6;-0.3,30,30,9,21,0,30,21,30,30,21,0,edgeCount
395,149,193,graphml/GtsCe.graphml,2,1,clustered,0.6;-0.3,37,37,10,27,4,-1,-11,12,10,2,4,edgeCount
394,149,193,graphml/GtsCe.graphml,2,1,clustered,0.6;-0.3,14,14,11,3,2,14,3,14,14,3,2,edgeCount
391,149,193,graphml/GtsCe.graphml,1,0,clustered,0.6;-0.3,-1,-1,9,-10,0,-1,-10,-1,-1,-10,0,edgeCount
390,149,193,graphml/GtsCe.graphml,2,1,clustered,0.6;-0.3,47,47,15,32,0,47,32,47,47,32,0,edgeCount
389,149,193,graphml/GtsCe.graphml,2,1,clustered,0.6;-0.3,19,65,16,3,2,19,3,19,65,3,2,edgeCount
386,149,193,graphml/GtsCe.graphml,3,2,clustered,0.6;-0.3,19,19,13,6,0,19,6,19,19,6,0,edgeCount
384,149,193,graphml/GtsCe.graphml,2,1,clustered,0.6;-0.3,17,17,17,0,0,17,0,17,17,0,0,edgeCount
383,149,193,graphml/GtsCe.graphml,2,1,clustered,0.6;-0.3,30,30,11,19,0,-1,-12,-1,-1,-12,0,edgeCount
381,149,193,graphml/GtsCe.graphml,2,1,clustered,0.6;-0.3,12,12,10,2,0,12,2,12,12,2,0,edgeCount
380,149,193,graphml/GtsCe.graphml,3,2,clustered,0.6;-0.3,70,70,15,55,2,130,115,70,70,55,2,edgeCount
379,149,193,graphml/GtsCe.graphml,2,1,clustered,0.6;-0.3,-1,-1,12,-13,4,-1,-13,-1,-1,-13,4,edgeCount
377,149,193,graphml/GtsCe.graphml,2,1,clustered,0.6;-0.3,-1,-1,14,-15,4,-1,-15,-1,-1,-15,4,edgeCount
376,149,193,graphml/GtsCe.graphml,1,0,clustered,0.6;-0.3,11,11,11,0,0,11,0,11,11,0,0,edgeCount
375,149,193,graphml/GtsCe.graphml,2,1,clustered,0.6;-0.3,3,3,3,0,0,3,0,3,3,0,0,edgeCount
374,149,193,graphml/GtsCe.graphml,3,2,clustered,0.6;-0.3,-1,-1,6,-7,0,-1,-7,-1,-1,-7,0,edgeCount
373,149,193,graphml/GtsCe.graphml,1,0,clustered,0.6;-0.3,10,10,10,0,0,10,0,10,10,0,0,edgeCount
372,149,193,graphml/GtsCe.graphml,2,1,clustered,0.6;-0.3,12,12,11,1,2,12,1,12,12,1,2,edgeCount
371,149,193,graphml/GtsCe.graphml,2,1,clustered,0.6;-0.3,5,5,5,0,0,5,0,5,5,0,0,edgeCount
370,149,193,graphml/GtsCe.graphml,2,1,clustered,0.6;-0.3,13,13,13,0,0,13,0,13,13,0,0,edgeCount
369,149,193,graphml/GtsCe.graphml,2,1,clustered,0.6;-0.3,12,12,12,0,0,12,0,12,12,0,0,edgeCount
368,149,193,graphml/GtsCe.graphml,3,2,clustered,0.6;-0.3,54,54,10,44,0,48,38,48,48,38,0,edgeCount
367,149,193,graphml/GtsCe.graphml,2,1,clustered,0.6;-0.3,19,33,6,13,4,-1,-7,22,24,16,4,edgeCount
365,149,193,graphml/GtsCe.graphml,2,1,clustered,0.6;-0.3,51,55,17,34,4,-1,-18,61,57,44,4,edgeCount
364,149,193,graphml/GtsCe.graphml,2,1,clustered,0.6;-0.3,74,42,18,56,0,-1,-19,-1,-1,-19,0,edgeCount
362,149,193,graphml/GtsCe.graphml,2,1,clustered,0.6;-0.3,52,46,15,37,0,46,31,46,46,31,0,edgeCount
361,149,193,graphml/GtsCe.graphml,2,1,clustered,0.6;-0.3,69,55,17,52,2,-1,-18,18,18,1,2,edgeCount
357,149,193,graphml/GtsCe.graphml,1,0,clustered,0.6;-0.3,9,9,9,0,0,9,0,9,9,0,0,edgeCount
356,149,193,graphml/GtsCe.graphml,2,1,clustered,0.6;-0.3,24,74,18,6,2,62,44,24,74,6,2,edgeCount
355,149,193,graphml/GtsCe.graphml,2,1,clustered,0.6;-0.3,10,10,10,0,0,10,0,10,10,0,0,edgeCount
353,149,193,graphml/GtsCe.graphml,2,1,clustered,0.6;-0.3,50,86,15,35,6,-1,-16,20,62,5,6,edgeCount
352,149,193,graphml/GtsCe.graphml,2,1,clustered,0.6;-0.3,18,18,17,1,0,18,1,18,18,1,0,edgeCount
351,149,193,graphml/GtsCe.graphml,2,1,clustered,0.6;-0.3,13,13,9,4,0,13,4,13,13,4,0,edgeCount
350,149,193,graphml/GtsCe.graphml,2,1,clustered,0.6;-0.3,44,28,5,39,6,-1,-6,5,5,0,6,edgeCount
348,149,193,graphml/GtsCe.graphml,2,1,clustered,0.6;-0.3,17,17,17,0,0,17,0,17,17,0,0,edgeCount
347,149,193,graphml/GtsCe.graphml,1,0,clustered,0.6;-0.3,10,10,10,0,0,10,0,10,10,0,0,edgeCount
346,149,193,graphml/GtsCe.graphml,2,1,clustered,0.6;-0.3,9,5,5,4,0,9,4,9,5,4,0,edgeCount
345,149,193,graphml/GtsCe.graphml,2,1,clustered,0.6;-0.3,20,20,19,1,0,20,1,20,20,1,0,edgeCount
344,149,193,graphml/GtsCe.graphml,2,1,clustered,0.6;-0.3,16,16,16,0,0,16,0,16,16,0,0,edgeCount
343,149,193,graphml/GtsCe.graphml,2,1,clustered,0.6;-0.3,17,17,17,0,0,17,0,17,17,0,0,edgeCount
342,149,193,graphml/GtsCe.graphml,2,1,clustered,0.6;-0.3,-1,-1,15,-16,4,-1,-16,-1,-1,-16,4,edgeCount
341,149,193,graphml/GtsCe.graphml,2,1,clustered,0.6;-0.3,20,16,8,12,0,-1,-9,-1,-1,-9,0,edgeCount
338,149,193,graphml/GtsCe.graphml,1,0,clustered,0.6;-0.3,2,2,2,0,0,2,0,2,2,0,0,edgeCount
337,149,193,graphml/GtsCe.graphml,2,1,clustered,0.6;-0.3,13,13,13,0,0,53,40,53,53,40,0,edgeCount
335,149,193,graphml/GtsCe.graphml,1,0,clustered,0.6;-0.3,4,4,4,0,0,4,0,4,4,0,0,edgeCount
334,149,193,graphml/GtsCe.graphml,1,0,clustered,0.6;-0.3,3,3,3,0,0,3,0,3,3,0,0,edgeCount
333,149,193,graphml/GtsCe.graphml,2,1,clustered,0.6;-0.3,28,28,8,20,0,28,20,28,28,20,0,edgeCount
332,149,193,graphml/GtsCe.graphml,2,1,clustered,0.6;-0.3,-1,-1,14,-15,2,-1,-15,-1,-1,-15,2,edgeCount
330,149,193,graphml/GtsCe.graphml,1,0,clustered,0.6;-0.3,-1,-1,10,-11,0,-1,-11,-1,-1,-11,0,edgeCount
329,149,193,graphml/GtsCe.graphml,2,1,clustered,0.6;-0.3,10,10,9,1,2,10,1,10,10,1,2,edgeCount
328,149,193,graphml/GtsCe.graphml,1,0,clustered,0.6;-0.3,15,15,15,0,0,15,0,15,15,0,0,edgeCount
327,149,193,graphml/GtsCe.graphml,2,1,clustered,0.6;-0.3,17,17,17,0,0,17,0,17,17,0,0,edgeCount
325,149,193,graphml/GtsCe.graphml,2,1,clustered,0.6;-0.3,23,23,11,12,2,23,12,23,23,12,2,edgeCount
324,149,193,graphml/GtsCe.graphml,2,1,clustered,0.6;-0.3,36,36,14,22,0,36,22,36,36,22,0,edgeCount
323,149,193,graphml/GtsCe.graphml,2,1,clustered,0.6;-0.3,4,4,3,1,0,4,1,4,4,1,0,edgeCount
319,149,193,graphml/GtsCe.graphml,3,2,clustered,0.6;-0.3,34,6,4,30,0,6,2,6,6,2,0,edgeCount
317,149,193,graphml/GtsCe.graphml,2,1,clustered,0.6;-0.3,56,52,17,39,2,-1,-18,-1,-1,-18,2,edgeCount
316,149,193,graphml/GtsCe.graphml,1,0,clustered,0.6;-0.3,-1,-1,10,-11,4,-1,-11,-1,-1,-11,4,edgeCount
315,149,193,graphml/GtsCe.graphml,2,1,clustered,0.6;-0.3,4,4,4,0,0,4,0,4,4,0,0,edgeCount
313,149,193,graphml/GtsCe.graphml,2,1,clustered,0.6;-0.3,10,10,10,0,2,10,0,10,10,0,2,edgeCount
312,149,193,graphml/GtsCe.graphml,2,1,clustered,0.6;-0.3,10,10,10,0,0,10,0,10,10,0,0,edgeCount
311,149,193,graphml/GtsCe.graphml,2,1,clustered,0.6;-0.3,4,4,4,0,2,4,0,4,4,0,2,edgeCount
310,149,193,graphml/GtsCe.graphml,2,1,clustered,0.6;-0.3,7,7,7,0,0,7,0,7,7,0,0,edgeCount
308,149,193,graphml/GtsCe.graphml,2,1,clustered,0.6;-0.3,30,30,15,15,2,-1,-16,30,30,15,2,edgeCount
306,149,193,graphml/GtsCe.graphml,2,1,clustered,0.6;-0.3,15,15,15,0,0,15,0,15,15,0,0,edgeCount
305,149,193,graphml/GtsCe.graphml,2,1,clustered,0.6;-0.3,38,72,13,25,4,-1,-14,14,54,1,4,edgeCount
304,149,193,graphml/GtsCe.graphml,3,2,clustered,0.6;-0.3,85,85,18,67,0,-1,-19,-1,-1,-19,0,edgeCount
303,149,193,graphml/GtsCe.graphml,1,0,clustered,0.6;-0.3,12,12,12,0,0,12,0,12,12,0,0,edgeCount
302,149,193,graphml/GtsCe.graphml,2,1,clustered,0.6;-0.3,62,62,21,41,0,62,41,62,62,41,0,edgeCount
300,149,193,graphml/GtsCe.graphml,2,1,clustered,0.6;-0.3,10,10,10,0,0,10,0,10,10,0,0,edgeCount
299,149,193,graphml/GtsCe.graphml,1,0,clustered,0.6;-0.3,-1,-1,12,-13,0,-1,-13,-1,-1,-13,0,edgeCount
298,149,193,graphml/GtsCe.graphml,2,1,clustered,0.6;-0.3,-1,-1,6,-7,2,-1,-7,-1,-1,-7,2,edgeCount
297,149,193,graphml/GtsCe.graphml,1,0,clustered,0.6;-0.3,8,28,8,0,2,8,0,8,28,0,2,edgeCount
296,149,193,graphml/GtsCe.graphml,3,2,clustered,0.6;-0.3,-1,-1,18,-19,0,-1,-19,-1,-1,-19,0,edgeCount
295,149,193,graphml/GtsCe.graphml,2,1,clustered,0.6;-0.3,51,51,13,38,0,37,24,37,37,24,0,edgeCount
294,149,193,graphml/GtsCe.graphml,2,1,clustered,0.6;-0.3,54,54,19,35,0,54,35,54,54,35,0,edgeCount
293,149,193,graphml/GtsCe.graphml,2,1,clustered,0.6;-0.3,-1,-1,29,-30,8,-1,-30,-1,-1,-30,8,edgeCount
292,149,193,graphml/GtsCe.graphml,1,0,clustered,0.6;-0.3,18,18,18,0,4,18,0,18,18,0,4,edgeCount
290,149,193,graphml/GtsCe.graphml,2,1,clustered,0.6;-0.3,-1,-1,11,-12,8,-1,-12,-1,-1,-12,8,edgeCount
283,149,193,graphml/GtsCe.graphml,1,0,clustered,0.6;-0.3,8,8,8,0,0,8,0,8,8,0,0,edgeCount
282,149,193,graphml/GtsCe.graphml,2,1,clustered,0.6;-0.3,-1,-1,16,-17,0,-1,-17,-1,-1,-17,0,edgeCount
280,149,193,graphml/GtsCe.graphml,1,0,clustered,0.6;-0.3,2,2,2,0,4,2,0,2,2,0,4,edgeCount
278,149,193,graphml/GtsCe.graphml,2,1,clustered,0.6;-0.3,18,18,8,10,2,18,10,10,26,2,2,edgeCount
277,149,193,graphml/GtsCe.graphml,2,1,clustered,0.6;-0.3,17,17,12,5,0,17,5,17,17,5,0,edgeCount
276,149,193,graphml/GtsCe.graphml,2,1,clustered,0.6;-0.3,21,15,8,13,2,-1,-9,-1,-1,-9,2,edgeCount
275,149,193,graphml/GtsCe.graphml,2,1,clustered,0.6;-0.3,5,5,5,0,0,5,0,5,5,0,0,edgeCount
274,149,193,graphml/GtsCe.graphml,2,1,clustered,0.6;-0.3,33,33,13,20,0,33,20,33,33,20,0,edgeCount
271,149,193,graphml/GtsCe.graphml,1,0,clustered,0.6;-0.3,5,17,5,0,2,5,0,5,17,0,2,edgeCount
270,149,193,graphml/GtsCe.graphml,1,0,clustered,0.6;-0.3,7,7,7,0,6,7,0,7,7,0,6,edgeCount
269,149,193,graphml/GtsCe.graphml,2,1,clustered,0.6;-0.3,17,17,15,2,2,17,2,17,17,2,2,edgeCount
266,149,193,graphml/GtsCe.graphml,2,1,clustered,0.6;-0.3,5,5,5,0,0,5,0,5,5,0,0,edgeCount
265,149,193,graphml/GtsCe.graphml,2,1,clustered,0.6;-0.3,33,33,10,23,6,29,19,29,29,19,6,edgeCount
264,149,193,graphml/GtsCe.graphml,1,0,clustered,0.6;-0.3,13,13,13,0,0,13,0,13,13,0,0,edgeCount
263,149,193,graphml/GtsCe.graphml,2,1,clustered,0.6;-0.3,24,16,5,19,0,-1,-6,-1,-1,-6,0,edgeCount
261,149,193,graphml/GtsCe.graphml,3,2,clustered,0.6;-0.3,79,79,13,66,0,81,68,79,79,66,0,edgeCount
260,149,193,graphml/GtsCe.graphml,2,1,clustered,0.6;-0.3,11,23,7,4,2,11,4,7,17,0,2,edgeCount
257,149,193,graphml/GtsCe.graphml,1,0,clustered,0.6;-0.3,47,19,15,32,6,-1,-16,47,19,32,6,edgeCount
256,149,193,graphml/GtsCe.graphml,2,1,clustered,0.6;-0.3,15,15,10,5,2,15,5,15,15,5,2,edgeCount
255,149,193,graphml/GtsCe.graphml,2,1,clustered,0.6;-0.3,8,8,8,0,0,8,0,8,8,0,0,edgeCount
254,149,193,graphml/GtsCe.graphml,1,0,clustered,0.6;-0.3,-1,-1,10,-11,0,-1,-11,-1,-1,-11,0,edgeCount
252,149,193,graphml/GtsCe.graphml,2,1,clustered,0.6;-0.3,21,33,9,12,0,21,12,21,21,12,0,edgeCount
250,149,193,graphml/GtsCe.graphml,2,1,clustered,0.6;-0.3,19,19,9,10,2,19,10,19,19,10,2,edgeCount
247,149,193,graphml/GtsCe.graphml,2,1,clustered,0.6;-0.3,46,46,15,31,0,46,31,46,46,31,0,edgeCount
245,149,193,graphml/GtsCe.graphml,3,2,clustered,0.6;-0.3,4,4,4,0,2,7,3,4,4,0,2,edgeCount
241,149,193,graphml/GtsCe.graphml,2,1,clustered,0.6;-0.3,28,28,11,17,4,-1,-12,28,28,17,4,edgeCount
238,149,193,graphml/GtsCe.graphml,2,1,clustered,0.6;-0.3,61,48,17,44,4,43,26,43,48,26,4,edgeCount
237,149,193,graphml/GtsCe.graphml,2,1,clustered,0.6;-0.3,-1,-1,19,-20,0,-1,-20,-1,-1,-20,0,edgeCount
236,149,193,graphml/GtsCe.graphml,1,0,clustered,0.6;-0.3,10,10,10,0,2,10,0,10,10,0,2,edgeCount
235,149,193,graphml/GtsCe.graphml,3,2,clustered,0.6;-0.3,39,39,11,28,4,39,28,39,39,28,4,edgeCount
234,149,193,graphml/GtsCe.graphml,1,0,clustered,0.6;-0.3,17,17,17,0,0,17,0,17,17,0,0,edgeCount
233,149,193,graphml/GtsCe.graphml,2,1,clustered,0.6;-0.3,12,34,5,7,4,12,7,6,30,1,4,edgeCount
232,149,193,graphml/GtsCe.graphml,2,1,clustered,0.6;-0.3,15,15,15,0,2,15,0,15,15,0,2,edgeCount
231,149,193,graphml/GtsCe.graphml,2,1,clustered,0.6;-0.3,5,5,5,0,2,5,0,5,5,0,2,edgeCount
230,149,193,graphml/GtsCe.graphml,2,1,clustered,0.6;-0.3,-1,-1,13,-14,0,-1,-14,-1,-1,-14,0,edgeCount
229,149,193,graphml/GtsCe.graphml,2,1,clustered,0.6;-0.3,-1,-1,11,-12,6,-1,-12,40,14,29,6,edgeCount
228,149,193,graphml/GtsCe.graphml,2,1,clustered,0.6;-0.3,4,4,4,0,2,4,0,18,16,14,2,edgeCount
227,149,193,graphml/GtsCe.graphml,2,1,clustered,0.6;-0.3,15,15,4,11,2,15,11,7,47,3,2,edgeCount
225,149,193,graphml/GtsCe.graphml,1,0,clustered,0.6;-0.3,33,33,14,19,2,-1,-15,33,33,19,2,edgeCount
220,149,193,graphml/GtsCe.graphml,2,1,clustered,0.6;-0.3,-1,-1,9,-10,0,-1,-10,-1,-1,-10,0,edgeCount
219,149,193,graphml/GtsCe.graphml,2,1,clustered,0.6;-0.3,8,8,8,0,8,8,0,8,8,0,8,edgeCount
218,149,193,graphml/GtsCe.graphml,3,2,clustered,0.6;-0.3,20,20,11,9,0,20,9,20,20,9,0,edgeCount
217,149,193,graphml/GtsCe.graphml,2,1,clustered,0.6;-0.3,22,14,11,11,0,20,9,20,20,9,0,edgeCount
216,149,193,graphml/GtsCe.graphml,2,1,clustered,0.6;-0.3,-1,-1,11,-12,0,-1,-12,-1,-1,-12,0,edgeCount
215,149,193,graphml/GtsCe.graphml,2,1,clustered,0.6;-0.3,16,16,6,10,0,16,10,16,16,10,0,edgeCount
214,149,193,graphml/GtsCe.graphml,2,1,clustered,0.6;-0.3,10,10,10,0,0,10,0,10,10,0,0,edgeCount
213,149,193,graphml/GtsCe.graphml,1,0,clustered,0.6;-0.3,-1,-1,5,-6,0,-1,-6,-1,-1,-6,0,edgeCount
210,149,193,graphml/GtsCe.graphml,2,1,clustered,0.6;-0.3,48,48,16,32,0,48,32,48,48,32,0,edgeCount
208,149,193,graphml/GtsCe.graphml,2,1,clustered,0.6;-0.3,11,11,11,0,0,11,0,11,11,0,0,edgeCount
205,149,193,graphml/GtsCe.graphml,2,1,clustered,0.6;-0.3,11,11,10,1,2,11,1,11,11,1,2,edgeCount
204,149,193,graphml/GtsCe.graphml,2,1,clustered,0.6;-0.3,5,5,5,0,2,-1,-6,-1,-1,-6,2,edgeCount
203,149,193,graphml/GtsCe.graphml,2,1,clustered,0.6;-0.3,35,15,12,23,2,-1,-13,31,29,19,2,edgeCount
202,149,193,graphml/GtsCe.graphml,2,1,clustered,0.6;-0.3,17,17,14,3,0,17,3,17,17,3,0,edgeCount
201,149,193,graphml/GtsCe.graphml,1,0,clustered,0.6;-0.3,21,21,21,0,0,21,0,21,21,0,0,edgeCount
200,149,193,graphml/GtsCe.graphml,1,0,clustered,0.6;-0.3,18,24,18,0,2,18,0,18,24,0,2,edgeCount
199,149,193,graphml/GtsCe.graphml,3,2,clustered,0.6;-0.3,88,90,11,77,2,88,77,18,18,7,2,edgeCount
197,149,193,graphml/GtsCe.graphml,2,1,clustered,0.6;-0.3,15,15,14,1,2,15,1,15,15,1,2,edgeCount
196,149,193,graphml/GtsCe.graphml,2,1,clustered,0.6;-0.3,2,2,2,0,2,2,0,2,2,0,2,edgeCount
195,149,193,graphml/GtsCe.graphml,2,1,clustered,0.6;-0.3,12,12,12,0,2,12,0,36,12,24,2,edgeCount
193,149,193,graphml/GtsCe.graphml,2,1,clustered,0.6;-0.3,13,13,13,0,0,13,0,13,13,0,0,edgeCount
192,149,193,graphml/GtsCe.graphml,2,1,clustered,0.6;-0.3,71,57,18,53,4,-1,-19,18,18,0,4,edgeCount
191,149,193,graphml/GtsCe.graphml,3,2,clustered,0.6;-0.3,6,6,6,0,0,6,0,6,6,0,0,edgeCount
190,149,193,graphml/GtsCe.graphml,2,1,clustered,0.6;-0.3,7,7,7,0,4,7,0,21,15,14,4,edgeCount
189,149,193,graphml/GtsCe.graphml,2,1,clustered,0.6;-0.3,27,27,11,16,0,25,14,25,25,14,0,edgeCount
188,149,193,graphml/GtsCe.graphml,2,1,clustered,0.6;-0.3,22,22,8,14,0,22,14,22,22,14,0,edgeCount
186,149,193,graphml/GtsCe.graphml,2,1,clustered,0.6;-0.3,48,48,14,34,4,-1,-15,-1,-1,-15,2,edgeCount
185,149,193,graphml/GtsCe.graphml,2,1,clustered,0.6;-0.3,5,5,5,0,0,5,0,5,5,0,0,edgeCount
184,149,193,graphml/GtsCe.graphml,2,1,clustered,0.6;-0.3,7,7,7,0,0,22,15,22,22,15,0,edgeCount
182,149,193,graphml/GtsCe.graphml,2,1,clustered,0.6;-0.3,11,11,5,6,0,11,6,11,11,6,0,edgeCount
181,149,193,graphml/GtsCe.graphml,2,1,clustered,0.6;-0.3,16,22,16,0,0,-1,-17,-1,-1,-17,0,edgeCount
179,149,193,graphml/GtsCe.graphml,1,0,clustered,0.6;-0.3,15,15,15,0,0,15,0,15,15,0,0,edgeCount
177,149,193,graphml/GtsCe.graphml,2,1,clustered,0.6;-0.3,49,49,13,36,0,49,36,49,49,36,0,edgeCount
174,149,193,graphml/GtsCe.graphml,2,1,clustered,0.6;-0.3,20,12,10,10,0,18,8,18,18,8,0,edgeCount
173,149,193,graphml/GtsCe.graphml,2,1,clustered,0.6;-0.3,12,51,7,5,6,12,5,12,51,5,6,edgeCount
171,149,193,graphml/GtsCe.graphml,1,0,clustered,0.6;-0.3,13,87,13,0,2,13,0,13,87,0,2,edgeCount
170,149,193,graphml/GtsCe.graphml,2,1,clustered,0.6;-0.3,4,4,4,0,8,4,0,18,4,14,8,edgeCount
169,149,193,graphml/GtsCe.graphml,2,1,clustered,0.6;-0.3,40,40,11,29,0,40,29,40,40,29,0,edgeCount
168,149,193,graphml/GtsCe.graphml,2,1,clustered,0.6;-0.3,29,27,7,22,4,-1,-8,27,7,20,4,edgeCount
167,149,193,graphml/GtsCe.graphml,3,2,clustered,0.6;-0.3,103,111,15,88,6,-1,-16,113,121,98,6,edgeCount
166,149,193,graphml/GtsCe.graphml,2,1,clustered,0.6;-0.3,10,10,10,0,2,10,0,10,10,0,2,edgeCount
165,149,193,graphml/GtsCe.graphml,2,1,clustered,0.6;-0.3,7,7,7,0,0,7,0,7,7,0,0,edgeCount
164,149,193,graphml/GtsCe.graphml,2,1,clustered,0.6;-0.3,3,3,3,0,6,3,0,3,3,0,6,edgeCount
163,149,193,graphml/GtsCe.graphml,2,1,clustered,0.6;-0.3,11,11,11,0,0,11,0,11,11,0,0,edgeCount
162,149,193,graphml/GtsCe.graphml,3,2,clustered,0.6;-0.3,18,18,11,7,2,52,41,54,48,43,2,edgeCount
161,149,193,graphml/GtsCe.graphml,3,2,clustered,0.6;-0.3,7,7,6,1,0,7,1,7,7,1,0,edgeCount
160,149,193,graphml/GtsCe.graphml,1,0,clustered,0.6;-0.3,2,2,2,0,0,2,0,2,2,0,0,edgeCount
158,149,193,graphml/GtsCe.graphml,2,1,clustered,0.6;-0.3,7,7,7,0,6,7,0,25,7,18,6,edgeCount
157,149,193,graphml/GtsCe.graphml,2,1,clustered,0.6;-0.3,58,58,12,46,4,-1,-13,46,46,34,4,edgeCount
156,149,193,graphml/GtsCe.graphml,2,1,clustered,0.6;-0.3,13,13,7,6,0,13,6,13,13,6,0,edgeCount
153,149,193,graphml/GtsCe.graphml,2,1,clustered,0.6;-0.3,11,11,9,2,0,11,2,11,11,2,0,edgeCount
152,149,193,graphml/GtsCe.graphml,2,1,clustered,0.6;-0.3,14,14,12,2,4,14,2,40,20,28,2,edgeCount
150,149,193,graphml/GtsCe.graphml,2,1,clustered,0.6;-0.3,5,5,4,1,2,5,1,5,13,1,2,edgeCount
149,149,193,graphml/GtsCe.graphml,2,1,clustered,0.6;-0.3,2,2,2,0,0,2,0,2,2,0,0,edgeCount
148,149,193,graphml/GtsCe.graphml,1,0,clustered,0.6;-0.3,17,17,17,0,0,17,0,17,17,0,0,edgeCount
144,149,193,graphml/GtsCe.graphml,2,1,clustered,0.6;-0.3,58,58,19,39,0,58,39,58,58,39,0,edgeCount
143,149,193,graphml/GtsCe.graphml,2,1,clustered,0.6;-0.3,64,50,19,45,4,-1,-20,19,19,0,4,edgeCount
142,149,193,graphml/GtsCe.graphml,2,1,clustered,0.6;-0.3,-1,-1,11,-12,0,-1,-12,-1,-1,-12,0,edgeCount
140,149,193,graphml/GtsCe.graphml,2,1,clustered,0.6;-0.3,26,26,13,13,0,26,13,26,26,13,0,edgeCount
139,149,193,graphml/GtsCe.graphml,2,1,clustered,0.6;-0.3,49,33,14,35,2,-1,-15,39,33,25,2,edgeCount
138,149,193,graphml/GtsCe.graphml,1,0,clustered,0.6;-0.3,3,3,3,0,0,3,0,3,3,0,0,edgeCount
137,149,193,graphml/GtsCe.graphml,1,0,clustered,0.6;-0.3,4,4,4,0,0,4,0,4,4,0,0,edgeCount
136,149,193,graphml/GtsCe.graphml,2,1,clustered,0.6;-0.3,54,52,15,39,0,52,37,52,52,37,0,edgeCount
133,149,193,graphml/GtsCe.graphml,2,1,clustered,0.6;-0.3,7,9,7,0,0,17,10,17,17,10,0,edgeCount
131,149,193,graphml/GtsCe.graphml,2,1,clustered,0.6;-0.3,2,2,2,0,0,2,0,2,2,0,0,edgeCount
130,149,193,graphml/GtsCe.graphml,2,1,clustered,0.6;-0.3,-1,-1,14,-15,0,-1,-15,-1,-1,-15,0,edgeCount
129,149,193,graphml/GtsCe.graphml,2,1,clustered,0.6;-0.3,11,11,11,0,0,11,0,11,11,0,0,edgeCount
128,149,193,graphml/GtsCe.graphml,1,0,clustered,0.6;-0.3,19,15,15,4,2,-1,-16,19,15,4,2,edgeCount
127,149,193,graphml/GtsCe.graphml,2,1,clustered,0.6;-0.3,10,10,10,0,2,10,0,10,10,0,2,edgeCount
126,149,193,graphml/GtsCe.graphml,3,2,clustered,0.6;-0.3,4,3,3,1,0,4,1,4,3,1,0,edgeCount
122,149,193,graphml/GtsCe.graphml,3,2,clustered,0.6;-0.3,39,37,11,28,6,-1,-12,57,15,46,6,edgeCount
121,149,193,graphml/GtsCe.graphml,2,1,clustered,0.6;-0.3,8,8,8,0,4,8,0,8,8,0,4,edgeCount
119,149,193,graphml/GtsCe.graphml,2,1,clustered,0.6;-0.3,32,32,11,21,0,32,21,32,32,21,0,edgeCount
118,149,193,graphml/GtsCe.graphml,2,1,clustered,0.6;-0.3,8,8,8,0,0,8,0,8,8,0,0,edgeCount
117,149,193,graphml/GtsCe.graphml,2,1,clustered,0.6;-0.3,10,8,8,2,0,10,2,10,8,2,0,edgeCount
116,149,193,graphml/GtsCe.graphml,2,1,clustered,0.6;-0.3,62,62,19,43,2,62,43,66,66,47,2,edgeCount
114,149,193,graphml/GtsCe.graphml,2,1,clustered,0.6;-0.3,34,34,10,24,0,12,2,34,34,24,0,edgeCount
113,149,193,graphml/GtsCe.graphml,2,1,clustered,0.6;-0.3,7,7,7,0,0,7,0,7,7,0,0,edgeCount
111,149,193,graphml/GtsCe.graphml,1,0,clustered,0.6;-0.3,20,20,20,0,0,20,0,20,20,0,0,edgeCount
110,149,193,graphml/GtsCe.graphml,1,0,clustered,0.6;-0.3,19,13,7,12,2,-1,-8,19,13,12,2,edgeCount
107,149,193,graphml/GtsCe.graphml,1,0,clustered,0.6;-0.3,12,12,12,0,0,12,0,12,12,0,0,edgeCount
106,149,193,graphml/GtsCe.graphml,2,1,clustered,0.6;-0.3,29,41,12,17,8,29,17,29,29,17,8,edgeCount
105,149,193,graphml/GtsCe.graphml,2,1,clustered,0.6;-0.3,36,36,14,22,0,36,22,36,36,22,0,edgeCount
104,149,193,graphml/GtsCe.graphml,1,0,clustered,0.6;-0.3,19,19,19,0,0,19,0,19,19,0,0,edgeCount
103,149,193,graphml/GtsCe.graphml,2,1,clustered,0.6;-0.3,8,8,8,0,2,26,18,14,40,6,2,edgeCount
102,149,193,graphml/GtsCe.graphml,2,1,clustered,0.6;-0.3,5,5,5,0,6,5,0,13,5,8,6,edgeCount
101,149,193,graphml/GtsCe.graphml,1,0,clustered,0.6;-0.3,11,18,11,0,4,11,0,11,18,0,4,edgeCount
100,149,193,graphml/GtsCe.graphml,3,2,clustered,0.6;-0.3,5,5,5,0,0,5,0,5,5,0,0,edgeCount
99,149,193,graphml/GtsCe.graphml,2,1,clustered,0.6;-0.3,13,13,13,0,0,13,0,13,13,0,0,edgeCount
97,149,193,graphml/GtsCe.graphml,3,2,clustered,0.6;-0.3,36,36,5,31,0,36,31,36,36,31,0,edgeCount
96,149,193,graphml/GtsCe.graphml,1,0,clustered,0.6;-0.3,32,32,19,13,2,-1,-20,32,32,13,2,edgeCount
95,149,193,graphml/GtsCe.graphml,3,2,clustered,0.6;-0.3,5,5,5,0,4,5,0,5,5,0,4,edgeCount
94,149,193,graphml/GtsCe.graphml,1,0,clustered,0.6;-0.3,8,8,8,0,0,8,0,8,8,0,0,edgeCount
93,149,193,graphml/GtsCe.graphml,2,1,clustered,0.6;-0.3,3,14,3,0,6,5,2,5,5,2,6,edgeCount
92,149,193,graphml/GtsCe.graphml,2,1,clustered,0.6;-0.3,11,11,11,0,0,11,0,11,11,0,0,edgeCount
91,149,193,graphml/GtsCe.graphml,2,1,clustered,0.6;-0.3,4,4,4,0,2,4,0,9,18,5,2,edgeCount
90,149,193,graphml/GtsCe.graphml,2,1,clustered,0.6;-0.3,6,6,6,0,0,6,0,6,6,0,0,edgeCount
86,149,193,graphml/GtsCe.graphml,2,1,clustered,0.6;-0.3,45,45,13,32,0,33,20,33,33,20,0,edgeCount
85,149,193,graphml/GtsCe.graphml,2,1,clustered,0.6;-0.3,44,44,12,32,0,44,32,44,44,32,0,edgeCount
84,149,193,graphml/GtsCe.graphml,2,1,clustered,0.6;-0.3,8,8,8,0,0,8,0,8,8,0,0,edgeCount
83,149,193,graphml/GtsCe.graphml,2,1,clustered,0.6;-0.3,22,42,10,12,0,22,12,22,22,12,0,edgeCount
80,149,193,graphml/GtsCe.graphml,2,1,clustered,0.6;-0.3,32,32,13,19,0,32,19,32,32,19,0,edgeCount
79,149,193,graphml/GtsCe.graphml,2,1,clustered,0.6;-0.3,6,6,6,0,2,6,0,6,6,0,2,edgeCount
78,149,193,graphml/GtsCe.graphml,2,1,clustered,0.6;-0.3,-1,-1,10,-11,0,-1,-11,-1,-1,-11,0,edgeCount
77,149,193,graphml/GtsCe.graphml,2,1,clustered,0.6;-0.3,37,43,12,25,2,-1,-13,15,15,3,2,edgeCount
75,149,193,graphml/GtsCe.graphml,2,1,clustered,0.6;-0.3,7,7,7,0,0,7,0,7,7,0,0,edgeCount
74,149,193,graphml/GtsCe.graphml,3,2,clustered,0.6;-0.3,58,58,12,46,0,58,46,58,58,46,0,edgeCount
73,149,193,graphml/GtsCe.graphml,3,2,clustered,0.6;-0.3,14,14,12,2,2,14,2,48,14,36,2,edgeCount
72,149,193,graphml/GtsCe.graphml,2,1,clustered,0.6;-0.3,42,36,16,26,2,-1,-17,42,36,26,2,edgeCount
71,149,193,graphml/GtsCe.graphml,2,1,clustered,0.6;-0.3,35,25,14,21,0,-1,-15,-1,-1,-15,0,edgeCount
70,149,193,graphml/GtsCe.graphml,2,1,clustered,0.6;-0.3,16,16,8,8,0,16,8,16,16,8,0,edgeCount
68,149,193,graphml/GtsCe.graphml,2,1,clustered,0.6;-0.3,60,60,17,43,4,-1,-18,22,20,5,4,edgeCount
66,149,193,graphml/GtsCe.graphml,1,0,clustered,0.6;-0.3,13,13,13,0,0,13,0,13,13,0,0,edgeCount
65,149,193,graphml/GtsCe.graphml,1,0,clustered,0.6;-0.3,13,13,13,0,0,13,0,13,13,0,0,edgeCount
64,149,193,graphml/GtsCe.graphml,3,2,clustered,0.6;-0.3,64,64,6,58,0,64,58,64,64,58,0,edgeCount
60,149,193,graphml/GtsCe.graphml,2,1,clustered,0.6;-0.3,6,6,5,1,0,6,1,6,6,1,0,edgeCount
59,149,193,graphml/GtsCe.graphml,2,1,clustered,0.6;-0.3,43,65,12,31,4,43,31,55,49,43,4,edgeCount
58,149,193,graphml/GtsCe.graphml,2,1,clustered,0.6;-0.3,7,7,6,1,0,19,13,7,7,1,0,edgeCount
57,149,193,graphml/GtsCe.graphml,2,1,clustered,0.6;-0.3,10,10,9,1,8,10,1,10,10,1,8,edgeCount
55,149,193,graphml/GtsCe.graphml,2,1,clustered,0.6;-0.3,6,6,6,0,0,6,0,6,6,0,0,edgeCount
53,149,193,graphml/GtsCe.graphml,2,1,clustered,0.6;-0.3,8,8,7,1,2,8,1,8,16,1,2,edgeCount
52,149,193,graphml/GtsCe.graphml,2,1,clustered,0.6;-0.3,21,21,15,6,0,21,6,21,21,6,0,edgeCount
51,149,193,graphml/GtsCe.graphml,3,2,clustered,0.6;-0.3,9,9,9,0,0,9,0,9,9,0,0,edgeCount
49,149,193,graphml/GtsCe.graphml,1,0,clustered,0.6;-0.3,17,17,17,0,4,17,0,17,17,0,4,edgeCount
48,149,193,graphml/GtsCe.graphml,2,1,clustered,0.6;-0.3,-1,-1,10,-11,0,-1,-11,-1,-1,-11,0,edgeCount
47,149,193,graphml/GtsCe.graphml,1,0,clustered,0.6;-0.3,10,10,10,0,0,10,0,10,10,0,0,edgeCount
46,149,193,graphml/GtsCe.graphml,2,1,clustered,0.6;-0.3,-1,-1,12,-13,0,-1,-13,-1,-1,-13,0,edgeCount
44,149,193,graphml/GtsCe.graphml,2,1,clustered,0.6;-0.3,68,24,20,48,0,22,2,22,22,2,0,edgeCount
42,149,193,graphml/GtsCe.graphml,2,1,clustered,0.6;-0.3,10,10,10,0,0,10,0,10,10,0,0,edgeCount
41,149,193,graphml/GtsCe.graphml,1,0,clustered,0.6;-0.3,4,4,4,0,0,4,0,4,4,0,0,edgeCount
40,149,193,graphml/GtsCe.graphml,2,1,clustered,0.6;-0.3,11,11,11,0,4,11,0,11,11,0,4,edgeCount
37,149,193,graphml/GtsCe.graphml,2,1,clustered,0.6;-0.3,31,27,12,19,2,-1,-13,26,12,14,2,edgeCount
36,149,193,graphml/GtsCe.graphml,2,1,clustered,0.6;-0.3,8,8,8,0,2,8,0,8,8,0,2,edgeCount
35,149,193,graphml/GtsCe.graphml,2,1,clustered,0.6;-0.3,11,11,11,0,0,11,0,11,11,0,0,edgeCount
34,149,193,graphml/GtsCe.graphml,2,1,clustered,0.6;-0.3,9,9,9,0,2,9,0,9,9,0,2,edgeCount
33,149,193,graphml/GtsCe.graphml,2,1,clustered,0.6;-0.3,13,13,13,0,0,13,0,13,13,0,0,edgeCount
32,149,193,graphml/GtsCe.graphml,2,1,clustered,0.6;-0.3,25,25,11,14,6,25,14,11,61,0,6,edgeCount
31,149,193,graphml/GtsCe.graphml,2,1,clustered,0.6;-0.3,3,3,3,0,0,3,0,3,3,0,0,edgeCount
30,149,193,graphml/GtsCe.graphml,2,1,clustered,0.6;-0.3,4,4,4,0,2,-1,-5,10,4,6,2,edgeCount
29,149,193,graphml/GtsCe.graphml,2,1,clustered,0.6;-0.3,37,51,11,26,0,13,2,37,37,26,0,edgeCount
28,149,193,graphml/GtsCe.graphml,2,1,clustered,0.6;-0.3,10,10,10,0,0,10,0,10,10,0,0,edgeCount
27,149,193,graphml/GtsCe.graphml,2,1,clustered,0.6;-0.3,15,15,7,8,0,7,0,7,15,0,0,edgeCount
26,149,193,graphml/GtsCe.graphml,2,1,clustered,0.6;-0.3,38,38,11,27,4,38,27,40,40,29,4,edgeCount
25,149,193,graphml/GtsCe.graphml,2,1,clustered,0.6;-0.3,52,46,23,29,2,-1,-24,-1,-1,-24,2,edgeCount
24,149,193,graphml/GtsCe.graphml,3,2,clustered,0.6;-0.3,10,10,10,0,0,10,0,10,10,0,0,edgeCount
23,149,193,graphml/GtsCe.graphml,2,1,clustered,0.6;-0.3,9,9,9,0,0,9,0,9,9,0,0,edgeCount
21,149,193,graphml/GtsCe.graphml,1,0,clustered,0.6;-0.3,14,14,14,0,0,14,0,14,14,0,0,edgeCount
20,149,193,graphml/GtsCe.graphml,2,1,clustered,0.6;-0.3,23,25,8,15,2,23,15,23,23,15,2,edgeCount
19,149,193,graphml/GtsCe.graphml,3,2,clustered,0.6;-0.3,16,16,8,8,0,16,8,16,16,8,0,edgeCount
17,149,193,graphml/GtsCe.graphml,2,1,clustered,0.6;-0.3,36,36,12,24,0,36,24,36,36,24,0,edgeCount
16,149,193,graphml/GtsCe.graphml,2,1,clustered,0.6;-0.3,26,26,10,16,0,26,16,26,26,16,0,edgeCount
15,149,193,graphml/GtsCe.graphml,2,1,clustered,0.6;-0.3,9,9,9,0,2,9,0,9,9,0,2,edgeCount
14,149,193,graphml/GtsCe.graphml,2,1,clustered,0.6;-0.3,9,7,6,3,0,9,3,9,7,3,0,edgeCount
13,149,193,graphml/GtsCe.graphml,1,0,clustered,0.6;-0.3,-1,-1,11,-12,0,-1,-12,-1,-1,-12,0,edgeCount
12,149,193,graphml/GtsCe.graphml,3,2,clustered,0.6;-0.3,85,117,14,71,4,37,23,37,109,23,4,edgeCount
11,149,193,graphml/GtsCe.graphml,2,1,clustered,0.6;-0.3,37,63,11,26,2,37,26,37,37,26,2,edgeCount
10,149,193,graphml/GtsCe.graphml,2,1,clustered,0.6;-0.3,18,18,8,10,0,18,10,18,18,10,0,edgeCount
9,149,193,graphml/GtsCe.graphml,1,0,clustered,0.6;-0.3,16,10,6,10,4,-1,-7,16,10,10,4,edgeCount
8,149,193,graphml/GtsCe.graphml,2,1,clustered,0.6;-0.3,10,10,10,0,8,10,0,10,10,0,8,edgeCount
7,149,193,graphml/GtsCe.graphml,2,1,clustered,0.6;-0.3,11,11,11,0,2,11,0,11,11,0,2,edgeCount
6,149,193,graphml/GtsCe.graphml,2,1,clustered,0.6;-0.3,16,16,8,8,0,16,8,16,16,8,0,edgeCount
5,149,193,graphml/GtsCe.graphml,1,0,clustered,0.6;-0.3,5,5,5,0,0,5,0,5,5,0,0,edgeCount
4,149,193,graphml/GtsCe.graphml,2,1,clustered,0.6;-0.3,10,10,8,2,6,33,25,13,10,5,6,edgeCount
3,149,193,graphml/GtsCe.graphml,1,0,clustered,0.6;-0.3,-1,-1,4,-5,0,-1,-5,-1,-1,-5,0,edgeCount
2,149,193,graphml/GtsCe.graphml,1,0,clustered,0.6;-0.3,9,9,9,0,0,9,0,9,9,0,0,edgeCount
1,149,193,graphml/GtsCe.graphml,2,1,clustered,0.6;-0.3,10,10,9,1,0,10,1,10,10,1,0,edgeCount
